0,0,理工类(全国性加分),703,2,12,11
1,0,理工类(全国性加分),702,5,17,13
2,0,理工类(全国性加分),699,2,19,18
3,0,理工类(全国性加分),698,6,25,20
4,0,理工类(全国性加分),697,2,27,26
5,0,理工类(全国性加分),696,6,33,28
6,0,理工类(全国性加分),695,4,37,34
7,0,理工类(全国性加分),694,2,39,38
8,0,理工类(全国性加分),693,3,42,40
9,0,理工类(全国性加分),692,4,46,43
10,0,理工类(全国性加分),691,7,53,47
11,0,理工类(全国性加分),690,12,65,54
12,0,理工类(全国性加分),689,7,72,66
13,0,理工类(全国性加分),688,6,78,73
14,0,理工类(全国性加分),687,10,88,79
15,0,理工类(全国性加分),686,14,102,89
16,0,理工类(全国性加分),685,11,113,103
17,0,理工类(全国性加分),684,7,120,114
18,0,理工类(全国性加分),683,11,131,121
19,0,理工类(全国性加分),682,14,145,132
20,0,理工类(全国性加分),681,13,158,146
21,0,理工类(全国性加分),680,15,173,159
22,0,理工类(全国性加分),679,14,187,174
23,0,理工类(全国性加分),678,12,199,188
24,0,理工类(全国性加分),677,18,217,200
25,0,理工类(全国性加分),676,16,233,218
26,0,理工类(全国性加分),675,23,256,234
27,0,理工类(全国性加分),674,16,272,257
28,0,理工类(全国性加分),673,15,287,273
29,0,理工类(全国性加分),672,17,304,288
30,0,理工类(全国性加分),671,24,328,305
31,0,理工类(全国性加分),670,22,350,329
32,0,理工类(全国性加分),669,17,367,351
33,0,理工类(全国性加分),668,36,403,368
34,0,理工类(全国性加分),667,25,428,404
35,0,理工类(全国性加分),666,37,465,429
36,0,理工类(全国性加分),665,27,492,466
37,0,理工类(全国性加分),664,36,528,493
38,0,理工类(全国性加分),663,28,556,529
39,0,理工类(全国性加分),662,43,599,557
40,0,理工类(全国性加分),661,42,641,600
41,0,理工类(全国性加分),660,46,687,642
42,0,理工类(全国性加分),659,54,741,688
43,0,理工类(全国性加分),658,44,785,742
44,0,理工类(全国性加分),657,43,828,786
45,0,理工类(全国性加分),656,55,883,829
46,0,理工类(全国性加分),655,40,923,884
47,0,理工类(全国性加分),654,56,979,924
48,0,理工类(全国性加分),653,50,1029,980
49,0,理工类(全国性加分),652,43,1072,1030
50,0,理工类(全国性加分),651,50,1122,1073
51,0,理工类(全国性加分),650,51,1173,1123
52,0,理工类(全国性加分),649,60,1233,1174
53,0,理工类(全国性加分),648,46,1279,1234
54,0,理工类(全国性加分),647,59,1338,1280
55,0,理工类(全国性加分),646,57,1395,1339
56,0,理工类(全国性加分),645,59,1454,1396
57,0,理工类(全国性加分),644,55,1509,1455
58,0,理工类(全国性加分),643,94,1603,1510
59,0,理工类(全国性加分),642,62,1665,1604
60,0,理工类(全国性加分),641,63,1728,1666
61,0,理工类(全国性加分),640,73,1801,1729
62,0,理工类(全国性加分),639,69,1870,1802
63,0,理工类(全国性加分),638,86,1956,1871
64,0,理工类(全国性加分),637,80,2036,1957
65,0,理工类(全国性加分),636,75,2111,2037
66,0,理工类(全国性加分),635,74,2185,2112
67,0,理工类(全国性加分),634,85,2270,2186
68,0,理工类(全国性加分),633,108,2378,2271
69,0,理工类(全国性加分),632,81,2459,2379
70,0,理工类(全国性加分),631,104,2563,2460
71,0,理工类(全国性加分),630,97,2660,2564
72,0,理工类(全国性加分),629,102,2762,2661
73,0,理工类(全国性加分),628,101,2863,2763
74,0,理工类(全国性加分),627,90,2953,2864
75,0,理工类(全国性加分),626,99,3052,2954
76,0,理工类(全国性加分),625,105,3157,3053
77,0,理工类(全国性加分),624,118,3275,3158
78,0,理工类(全国性加分),623,103,3378,3276
79,0,理工类(全国性加分),622,113,3491,3379
80,0,理工类(全国性加分),621,122,3613,3492
81,0,理工类(全国性加分),620,130,3743,3614
82,0,理工类(全国性加分),619,116,3859,3744
83,0,理工类(全国性加分),618,146,4005,3860
84,0,理工类(全国性加分),617,125,4130,4006
85,0,理工类(全国性加分),616,127,4257,4131
86,0,理工类(全国性加分),615,154,4411,4258
87,0,理工类(全国性加分),614,139,4550,4412
88,0,理工类(全国性加分),613,130,4680,4551
89,0,理工类(全国性加分),612,131,4811,4681
90,0,理工类(全国性加分),611,155,4966,4812
91,0,理工类(全国性加分),610,142,5108,4967
92,0,理工类(全国性加分),609,131,5239,5109
93,0,理工类(全国性加分),608,157,5396,5240
94,0,理工类(全国性加分),607,165,5561,5397
95,0,理工类(全国性加分),606,159,5720,5562
96,0,理工类(全国性加分),605,183,5903,5721
97,0,理工类(全国性加分),604,171,6074,5904
98,0,理工类(全国性加分),603,166,6240,6075
99,0,理工类(全国性加分),602,183,6423,6241
100,0,理工类(全国性加分),601,165,6588,6424
101,0,理工类(全国性加分),600,187,6775,6589
102,0,理工类(全国性加分),599,184,6959,6776
103,0,理工类(全国性加分),598,193,7152,6960
104,0,理工类(全国性加分),597,176,7328,7153
105,0,理工类(全国性加分),596,193,7521,7329
106,0,理工类(全国性加分),595,201,7722,7522
107,0,理工类(全国性加分),594,199,7921,7723
108,0,理工类(全国性加分),593,204,8125,7922
109,0,理工类(全国性加分),592,188,8313,8126
110,0,理工类(全国性加分),591,176,8489,8314
111,0,理工类(全国性加分),590,201,8690,8490
112,0,理工类(全国性加分),589,227,8917,8691
113,0,理工类(全国性加分),588,228,9145,8918
114,0,理工类(全国性加分),587,228,9373,9146
115,0,理工类(全国性加分),586,225,9598,9374
116,0,理工类(全国性加分),585,239,9837,9599
117,0,理工类(全国性加分),584,277,10114,9838
118,0,理工类(全国性加分),583,232,10346,10115
119,0,理工类(全国性加分),582,223,10569,10347
120,0,理工类(全国性加分),581,244,10813,10570
121,0,理工类(全国性加分),580,235,11048,10814
122,0,理工类(全国性加分),579,223,11271,11049
123,0,理工类(全国性加分),578,259,11530,11272
124,0,理工类(全国性加分),577,261,11791,11531
125,0,理工类(全国性加分),576,231,12022,11792
126,0,理工类(全国性加分),575,253,12275,12023
127,0,理工类(全国性加分),574,270,12545,12276
128,0,理工类(全国性加分),573,253,12798,12546
129,0,理工类(全国性加分),572,260,13058,12799
130,0,理工类(全国性加分),571,310,13368,13059
131,0,理工类(全国性加分),570,269,13637,13369
132,0,理工类(全国性加分),569,280,13917,13638
133,0,理工类(全国性加分),568,251,14168,13918
134,0,理工类(全国性加分),567,290,14458,14169
135,0,理工类(全国性加分),566,293,14751,14459
136,0,理工类(全国性加分),565,273,15024,14752
137,0,理工类(全国性加分),564,277,15301,15025
138,0,理工类(全国性加分),563,294,15595,15302
139,0,理工类(全国性加分),562,284,15879,15596
140,0,理工类(全国性加分),561,284,16163,15880
141,0,理工类(全国性加分),560,304,16467,16164
142,0,理工类(全国性加分),559,319,16786,16468
143,0,理工类(全国性加分),558,313,17099,16787
144,0,理工类(全国性加分),557,304,17403,17100
145,0,理工类(全国性加分),556,356,17759,17404
146,0,理工类(全国性加分),555,367,18126,17760
147,0,理工类(全国性加分),554,305,18431,18127
148,0,理工类(全国性加分),553,346,18777,18432
149,0,理工类(全国性加分),552,322,19099,18778
150,0,理工类(全国性加分),551,342,19441,19100
151,0,理工类(全国性加分),550,370,19811,19442
152,0,理工类(全国性加分),549,327,20138,19812
153,0,理工类(全国性加分),548,353,20491,20139
154,0,理工类(全国性加分),547,309,20800,20492
155,0,理工类(全国性加分),546,366,21166,20801
156,0,理工类(全国性加分),545,328,21494,21167
157,0,理工类(全国性加分),544,331,21825,21495
158,0,理工类(全国性加分),543,343,22168,21826
159,0,理工类(全国性加分),542,365,22533,22169
160,0,理工类(全国性加分),541,351,22884,22534
161,0,理工类(全国性加分),540,358,23242,22885
162,0,理工类(全国性加分),539,377,23619,23243
163,0,理工类(全国性加分),538,366,23985,23620
164,0,理工类(全国性加分),537,414,24399,23986
165,0,理工类(全国性加分),536,386,24785,24400
166,0,理工类(全国性加分),535,367,25152,24786
167,0,理工类(全国性加分),534,365,25517,25153
168,0,理工类(全国性加分),533,395,25912,25518
169,0,理工类(全国性加分),532,401,26313,25913
170,0,理工类(全国性加分),531,403,26716,26314
171,0,理工类(全国性加分),530,416,27132,26717
172,0,理工类(全国性加分),529,391,27523,27133
173,0,理工类(全国性加分),528,378,27901,27524
174,0,理工类(全国性加分),527,371,28272,27902
175,0,理工类(全国性加分),526,383,28655,28273
176,0,理工类(全国性加分),525,411,29066,28656
177,0,理工类(全国性加分),524,429,29495,29067
178,0,理工类(全国性加分),523,410,29905,29496
179,0,理工类(全国性加分),522,414,30319,29906
180,0,理工类(全国性加分),521,445,30764,30320
181,0,理工类(全国性加分),520,403,31167,30765
182,0,理工类(全国性加分),519,409,31576,31168
183,0,理工类(全国性加分),518,421,31997,31577
184,0,理工类(全国性加分),517,422,32419,31998
185,0,理工类(全国性加分),516,427,32846,32420
186,0,理工类(全国性加分),515,391,33237,32847
187,0,理工类(全国性加分),514,393,33630,33238
188,0,理工类(全国性加分),513,463,34093,33631
189,0,理工类(全国性加分),512,451,34544,34094
190,0,理工类(全国性加分),511,419,34963,34545
191,0,理工类(全国性加分),510,470,35433,34964
192,0,理工类(全国性加分),509,466,35899,35434
193,0,理工类(全国性加分),508,426,36325,35900
194,0,理工类(全国性加分),507,426,36751,36326
195,0,理工类(全国性加分),506,499,37250,36752
196,0,理工类(全国性加分),505,447,37697,37251
197,0,理工类(全国性加分),504,434,38131,37698
198,0,理工类(全国性加分),503,491,38622,38132
199,0,理工类(全国性加分),502,463,39085,38623
200,0,理工类(全国性加分),501,429,39514,39086
201,0,理工类(全国性加分),500,425,39939,39515
202,0,理工类(全国性加分),499,460,40399,39940
203,0,理工类(全国性加分),498,496,40895,40400
204,0,理工类(全国性加分),497,452,41347,40896
205,0,理工类(全国性加分),496,464,41811,41348
206,0,理工类(全国性加分),495,472,42283,41812
207,0,理工类(全国性加分),494,450,42733,42284
208,0,理工类(全国性加分),493,442,43175,42734
209,0,理工类(全国性加分),492,459,43634,43176
210,0,理工类(全国性加分),491,525,44159,43635
211,0,理工类(全国性加分),490,484,44643,44160
212,0,理工类(全国性加分),489,480,45123,44644
213,0,理工类(全国性加分),488,531,45654,45124
214,0,理工类(全国性加分),487,469,46123,45655
215,0,理工类(全国性加分),486,514,46637,46124
216,0,理工类(全国性加分),485,510,47147,46638
217,0,理工类(全国性加分),484,513,47660,47148
218,0,理工类(全国性加分),483,501,48161,47661
219,0,理工类(全国性加分),482,470,48631,48162
220,0,理工类(全国性加分),481,516,49147,48632
221,0,理工类(全国性加分),480,505,49652,49148
222,0,理工类(全国性加分),479,483,50135,49653
223,0,理工类(全国性加分),478,521,50656,50136
224,0,理工类(全国性加分),477,510,51166,50657
225,0,理工类(全国性加分),476,517,51683,51167
226,0,理工类(全国性加分),475,539,52222,51684
227,0,理工类(全国性加分),474,502,52724,52223
228,0,理工类(全国性加分),473,507,53231,52725
229,0,理工类(全国性加分),472,499,53730,53232
230,0,理工类(全国性加分),471,475,54205,53731
231,0,理工类(全国性加分),470,530,54735,54206
232,0,理工类(全国性加分),469,525,55260,54736
233,0,理工类(全国性加分),468,520,55780,55261
234,0,理工类(全国性加分),467,518,56298,55781
235,0,理工类(全国性加分),466,537,56835,56299
236,0,理工类(全国性加分),465,582,57417,56836
237,0,理工类(全国性加分),464,539,57956,57418
238,0,理工类(全国性加分),463,526,58482,57957
239,0,理工类(全国性加分),462,566,59048,58483
240,0,理工类(全国性加分),461,522,59570,59049
241,0,理工类(全国性加分),460,517,60087,59571
242,0,理工类(全国性加分),459,542,60629,60088
243,0,理工类(全国性加分),458,561,61190,60630
244,0,理工类(全国性加分),457,551,61741,61191
245,0,理工类(全国性加分),456,542,62283,61742
246,0,理工类(全国性加分),455,528,62811,62284
247,0,理工类(全国性加分),454,567,63378,62812
248,0,理工类(全国性加分),453,524,63902,63379
249,0,理工类(全国性加分),452,538,64440,63903
250,0,理工类(全国性加分),451,556,64996,64441
251,0,理工类(全国性加分),450,556,65552,64997
252,0,理工类(全国性加分),449,558,66110,65553
253,0,理工类(全国性加分),448,545,66655,66111
254,0,理工类(全国性加分),447,528,67183,66656
255,0,理工类(全国性加分),446,560,67743,67184
256,0,理工类(全国性加分),445,543,68286,67744
257,0,理工类(全国性加分),444,564,68850,68287
258,0,理工类(全国性加分),443,573,69423,68851
259,0,理工类(全国性加分),442,550,69973,69424
260,0,理工类(全国性加分),441,582,70555,69974
261,0,理工类(全国性加分),440,567,71122,70556
262,0,理工类(全国性加分),439,603,71725,71123
263,0,理工类(全国性加分),438,562,72287,71726
264,0,理工类(全国性加分),437,597,72884,72288
265,0,理工类(全国性加分),436,585,73469,72885
266,0,理工类(全国性加分),435,602,74071,73470
267,0,理工类(全国性加分),434,627,74698,74072
268,0,理工类(全国性加分),433,590,75288,74699
269,0,理工类(全国性加分),432,614,75902,75289
270,0,理工类(全国性加分),431,593,76495,75903
271,0,理工类(全国性加分),430,591,77086,76496
272,0,理工类(全国性加分),429,608,77694,77087
273,0,理工类(全国性加分),428,641,78335,77695
274,0,理工类(全国性加分),427,607,78942,78336
275,0,理工类(全国性加分),426,634,79576,78943
276,0,理工类(全国性加分),425,617,80193,79577
277,0,理工类(全国性加分),424,649,80842,80194
278,0,理工类(全国性加分),423,616,81458,80843
279,0,理工类(全国性加分),422,624,82082,81459
280,0,理工类(全国性加分),421,661,82743,82083
281,0,理工类(全国性加分),420,651,83394,82744
282,0,理工类(全国性加分),419,621,84015,83395
283,0,理工类(全国性加分),418,570,84585,84016
284,0,理工类(全国性加分),417,641,85226,84586
285,0,理工类(全国性加分),416,667,85893,85227
286,0,理工类(全国性加分),415,682,86575,85894
287,0,理工类(全国性加分),414,635,87210,86576
288,0,理工类(全国性加分),413,651,87861,87211
289,0,理工类(全国性加分),412,689,88550,87862
290,0,理工类(全国性加分),411,648,89198,88551
291,0,理工类(全国性加分),410,677,89875,89199
292,0,理工类(全国性加分),409,641,90516,89876
293,0,理工类(全国性加分),408,608,91124,90517
294,0,理工类(全国性加分),407,693,91817,91125
295,0,理工类(全国性加分),406,628,92445,91818
296,0,理工类(全国性加分),405,661,93106,92446
297,0,理工类(全国性加分),404,660,93766,93107
298,0,理工类(全国性加分),403,709,94475,93767
299,0,理工类(全国性加分),402,637,95112,94476
300,0,理工类(全国性加分),401,701,95813,95113
301,0,理工类(全国性加分),400,682,96495,95814
302,0,理工类(全国性加分),399,681,97176,96496
303,0,理工类(全国性加分),398,705,97881,97177
304,0,理工类(全国性加分),397,708,98589,97882
305,0,理工类(全国性加分),396,734,99323,98590
306,0,理工类(全国性加分),395,623,99946,99324
307,0,理工类(全国性加分),394,663,100609,99947
308,0,理工类(全国性加分),393,747,101356,100610
309,0,理工类(全国性加分),392,716,102072,101357
310,0,理工类(全国性加分),391,709,102781,102073
311,0,理工类(全国性加分),390,712,103493,102782
312,0,理工类(全国性加分),389,654,104147,103494
313,0,理工类(全国性加分),388,671,104818,104148
314,0,理工类(全国性加分),387,719,105537,104819
315,0,理工类(全国性加分),386,726,106263,105538
316,0,理工类(全国性加分),385,698,106961,106264
317,0,理工类(全国性加分),384,679,107640,106962
318,0,理工类(全国性加分),383,690,108330,107641
319,0,理工类(全国性加分),382,740,109070,108331
320,0,理工类(全国性加分),381,692,109762,109071
321,0,理工类(全国性加分),380,707,110469,109763
322,0,理工类(全国性加分),379,711,111180,110470
323,0,理工类(全国性加分),378,670,111850,111181
324,0,理工类(全国性加分),377,731,112581,111851
325,0,理工类(全国性加分),376,708,113289,112582
326,0,理工类(全国性加分),375,694,113983,113290
327,0,理工类(全国性加分),374,707,114690,113984
328,0,理工类(全国性加分),373,707,115397,114691
329,0,理工类(全国性加分),372,699,116096,115398
330,0,理工类(全国性加分),371,773,116869,116097
331,0,理工类(全国性加分),370,736,117605,116870
332,0,理工类(全国性加分),369,738,118343,117606
333,0,理工类(全国性加分),368,710,119053,118344
334,0,理工类(全国性加分),367,718,119771,119054
335,0,理工类(全国性加分),366,739,120510,119772
336,0,理工类(全国性加分),365,689,121199,120511
337,0,理工类(全国性加分),364,719,121918,121200
338,0,理工类(全国性加分),363,717,122635,121919
339,0,理工类(全国性加分),362,725,123360,122636
340,0,理工类(全国性加分),361,685,124045,123361
341,0,理工类(全国性加分),360,724,124769,124046
342,0,理工类(全国性加分),359,737,125506,124770
343,0,理工类(全国性加分),358,710,126216,125507
344,0,理工类(全国性加分),357,699,126915,126217
345,0,理工类(全国性加分),356,718,127633,126916
346,0,理工类(全国性加分),355,707,128340,127634
347,0,理工类(全国性加分),354,773,129113,128341
348,0,理工类(全国性加分),353,681,129794,129114
349,0,理工类(全国性加分),352,723,130517,129795
350,0,理工类(全国性加分),351,669,131186,130518
351,0,理工类(全国性加分),350,703,131889,131187
352,0,理工类(全国性加分),349,718,132607,131890
353,0,理工类(全国性加分),348,669,133276,132608
354,0,理工类(全国性加分),347,675,133951,133277
355,0,理工类(全国性加分),346,691,134642,133952
356,0,理工类(全国性加分),345,725,135367,134643
357,0,理工类(全国性加分),344,749,136116,135368
358,0,理工类(全国性加分),343,691,136807,136117
359,0,理工类(全国性加分),342,674,137481,136808
360,0,理工类(全国性加分),341,654,138135,137482
361,0,理工类(全国性加分),340,714,138849,138136
362,0,理工类(全国性加分),339,643,139492,138850
363,0,理工类(全国性加分),338,684,140176,139493
364,0,理工类(全国性加分),337,709,140885,140177
365,0,理工类(全国性加分),336,654,141539,140886
366,0,理工类(全国性加分),335,663,142202,141540
367,0,理工类(全国性加分),334,606,142808,142203
368,0,理工类(全国性加分),333,688,143496,142809
369,0,理工类(全国性加分),332,652,144148,143497
370,0,理工类(全国性加分),331,643,144791,144149
371,0,理工类(全国性加分),330,652,145443,144792
372,0,理工类(全国性加分),329,667,146110,145444
373,0,理工类(全国性加分),328,660,146770,146111
374,0,理工类(全国性加分),327,647,147417,146771
375,0,理工类(全国性加分),326,606,148023,147418
376,0,理工类(全国性加分),325,606,148629,148024
377,0,理工类(全国性加分),324,642,149271,148630
378,0,理工类(全国性加分),323,573,149844,149272
379,0,理工类(全国性加分),322,637,150481,149845
380,0,理工类(全国性加分),321,615,151096,150482
381,0,理工类(全国性加分),320,628,151724,151097
382,0,理工类(全国性加分),319,582,152306,151725
383,0,理工类(全国性加分),318,625,152931,152307
384,0,理工类(全国性加分),317,621,153552,152932
385,0,理工类(全国性加分),316,600,154152,153553
386,0,理工类(全国性加分),315,609,154761,154153
387,0,理工类(全国性加分),314,573,155334,154762
388,0,理工类(全国性加分),313,594,155928,155335
389,0,理工类(全国性加分),312,636,156564,155929
390,0,理工类(全国性加分),311,574,157138,156565
391,0,理工类(全国性加分),310,546,157684,157139
392,0,理工类(全国性加分),309,572,158256,157685
393,0,理工类(全国性加分),308,563,158819,158257
394,0,理工类(全国性加分),307,573,159392,158820
395,0,理工类(全国性加分),306,574,159966,159393
396,0,理工类(全国性加分),305,572,160538,159967
397,0,理工类(全国性加分),304,533,161071,160539
398,0,理工类(全国性加分),303,563,161634,161072
399,0,理工类(全国性加分),302,564,162198,161635
400,0,理工类(全国性加分),301,554,162752,162199
401,0,理工类(全国性加分),300,541,163293,162753
402,0,理工类(全国性加分),299,507,163800,163294
403,0,理工类(全国性加分),298,557,164357,163801
404,0,理工类(全国性加分),297,563,164920,164358
405,0,理工类(全国性加分),296,503,165423,164921
406,0,理工类(全国性加分),295,467,165890,165424
407,0,理工类(全国性加分),294,572,166462,165891
408,0,理工类(全国性加分),293,480,166942,166463
409,0,理工类(全国性加分),292,543,167485,166943
410,0,理工类(全国性加分),291,502,167987,167486
411,0,理工类(全国性加分),290,528,168515,167988
412,0,理工类(全国性加分),289,551,169066,168516
413,0,理工类(全国性加分),288,506,169572,169067
414,0,理工类(全国性加分),287,529,170101,169573
415,0,理工类(全国性加分),286,510,170611,170102
416,0,理工类(全国性加分),285,456,171067,170612
417,0,理工类(全国性加分),284,467,171534,171068
418,0,理工类(全国性加分),283,488,172022,171535
419,0,理工类(全国性加分),282,481,172503,172023
420,0,理工类(全国性加分),281,495,172998,172504
421,0,理工类(全国性加分),280,500,173498,172999
422,0,理工类(全国性加分),279,485,173983,173499
423,0,理工类(全国性加分),278,493,174476,173984
424,0,理工类(全国性加分),277,450,174926,174477
425,0,理工类(全国性加分),276,438,175364,174927
426,0,理工类(全国性加分),275,474,175838,175365
427,0,理工类(全国性加分),274,462,176300,175839
428,0,理工类(全国性加分),273,453,176753,176301
429,0,理工类(全国性加分),272,433,177186,176754
430,0,理工类(全国性加分),271,401,177587,177187
431,0,理工类(全国性加分),270,408,177995,177588
432,0,理工类(全国性加分),269,427,178422,177996
433,0,理工类(全国性加分),268,425,178847,178423
434,0,理工类(全国性加分),267,395,179242,178848
435,0,理工类(全国性加分),266,394,179636,179243
436,0,理工类(全国性加分),265,381,180017,179637
437,0,理工类(全国性加分),264,414,180431,180018
438,0,理工类(全国性加分),263,413,180844,180432
439,0,理工类(全国性加分),262,398,181242,180845
440,0,理工类(全国性加分),261,351,181593,181243
441,0,理工类(全国性加分),260,398,181991,181594
442,0,理工类(全国性加分),259,395,182386,181992
443,0,理工类(全国性加分),258,399,182785,182387
444,0,理工类(全国性加分),257,424,183209,182786
445,0,理工类(全国性加分),256,365,183574,183210
446,0,理工类(全国性加分),255,387,183961,183575
447,0,理工类(全国性加分),254,335,184296,183962
448,0,理工类(全国性加分),253,364,184660,184297
449,0,理工类(全国性加分),252,367,185027,184661
450,0,理工类(全国性加分),251,360,185387,185028
451,0,理工类(全国性加分),250,346,185733,185388
452,0,理工类(全国性加分),249,326,186059,185734
453,0,理工类(全国性加分),248,335,186394,186060
454,0,理工类(全国性加分),247,319,186713,186395
455,0,理工类(全国性加分),246,366,187079,186714
456,0,理工类(全国性加分),245,344,187423,187080
457,0,理工类(全国性加分),244,306,187729,187424
458,0,理工类(全国性加分),243,328,188057,187730
459,0,理工类(全国性加分),242,346,188403,188058
460,0,理工类(全国性加分),241,293,188696,188404
461,0,理工类(全国性加分),240,333,189029,188697
462,0,理工类(全国性加分),239,315,189344,189030
463,0,理工类(全国性加分),238,307,189651,189345
464,0,理工类(全国性加分),237,265,189916,189652
465,0,理工类(全国性加分),236,274,190190,189917
466,0,理工类(全国性加分),235,268,190458,190191
467,0,理工类(全国性加分),234,280,190738,190459
468,0,理工类(全国性加分),233,276,191014,190739
469,0,理工类(全国性加分),232,288,191302,191015
470,0,理工类(全国性加分),231,268,191570,191303
471,0,理工类(全国性加分),230,262,191832,191571
472,0,理工类(全国性加分),229,277,192109,191833
473,0,理工类(全国性加分),228,243,192352,192110
474,0,理工类(全国性加分),227,261,192613,192353
475,0,理工类(全国性加分),226,279,192892,192614
476,0,理工类(全国性加分),225,227,193119,192893
477,0,理工类(全国性加分),224,239,193358,193120
478,0,理工类(全国性加分),223,210,193568,193359
479,0,理工类(全国性加分),222,223,193791,193569
480,0,理工类(全国性加分),221,216,194007,193792
481,0,理工类(全国性加分),220,224,194231,194008
482,0,理工类(全国性加分),219,225,194456,194232
483,0,理工类(全国性加分),218,224,194680,194457
484,0,理工类(全国性加分),217,221,194901,194681
485,0,理工类(全国性加分),216,200,195101,194902
486,0,理工类(全国性加分),215,189,195290,195102
487,0,理工类(全国性加分),214,212,195502,195291
488,0,理工类(全国性加分),213,180,195682,195503
489,0,理工类(全国性加分),212,212,195894,195683
490,0,理工类(全国性加分),211,209,196103,195895
491,0,理工类(全国性加分),210,208,196311,196104
492,0,理工类(全国性加分),209,189,196500,196312
493,0,理工类(全国性加分),208,185,196685,196501
494,0,理工类(全国性加分),207,180,196865,196686
495,0,理工类(全国性加分),206,169,197034,196866
496,0,理工类(全国性加分),205,171,197205,197035
497,0,理工类(全国性加分),204,160,197365,197206
498,0,理工类(全国性加分),203,178,197543,197366
499,0,理工类(全国性加分),202,164,197707,197544
500,0,理工类(全国性加分),201,148,197855,197708
501,0,理工类(全国性加分),200,166,198021,197856
502,0,理工类(全国性加分),199,147,198168,198022
503,0,理工类(全国性加分),198,150,198318,198169
504,0,理工类(全国性加分),197,142,198460,198319
505,0,理工类(全国性加分),196,157,198617,198461
506,0,理工类(全国性加分),195,140,198757,198618
507,0,理工类(全国性加分),194,149,198906,198758
508,0,理工类(全国性加分),193,115,199021,198907
509,0,理工类(全国性加分),192,131,199152,199022
510,0,理工类(全国性加分),191,139,199291,199153
511,0,理工类(全国性加分),190,109,199400,199292
512,0,理工类(全国性加分),189,119,199519,199401
513,0,理工类(全国性加分),188,108,199627,199520
514,0,理工类(全国性加分),187,132,199759,199628
515,0,理工类(全国性加分),186,117,199876,199760
516,0,理工类(全国性加分),185,116,199992,199877
517,0,理工类(全国性加分),184,135,200127,199993
518,0,理工类(全国性加分),183,126,200253,200128
519,0,理工类(全国性加分),182,91,200344,200254
520,0,理工类(全国性加分),181,103,200447,200345
521,0,理工类(全国性加分),180,106,200553,200448
522,1,文史类(全国性加分),658,2,12,11
523,1,文史类(全国性加分),657,1,13,13
524,1,文史类(全国性加分),656,1,14,14
525,1,文史类(全国性加分),655,2,16,15
526,1,文史类(全国性加分),654,2,18,17
527,1,文史类(全国性加分),652,5,23,19
528,1,文史类(全国性加分),651,1,24,24
529,1,文史类(全国性加分),648,6,30,25
530,1,文史类(全国性加分),647,1,31,31
531,1,文史类(全国性加分),646,2,33,32
532,1,文史类(全国性加分),645,4,37,34
533,1,文史类(全国性加分),644,5,42,38
534,1,文史类(全国性加分),643,3,45,43
535,1,文史类(全国性加分),642,4,49,46
536,1,文史类(全国性加分),641,5,54,50
537,1,文史类(全国性加分),640,1,55,55
538,1,文史类(全国性加分),639,4,59,56
539,1,文史类(全国性加分),638,4,63,60
540,1,文史类(全国性加分),637,3,66,64
541,1,文史类(全国性加分),636,4,70,67
542,1,文史类(全国性加分),635,3,73,71
543,1,文史类(全国性加分),634,6,79,74
544,1,文史类(全国性加分),633,6,85,80
545,1,文史类(全国性加分),632,7,92,86
546,1,文史类(全国性加分),631,10,102,93
547,1,文史类(全国性加分),630,8,110,103
548,1,文史类(全国性加分),629,7,117,111
549,1,文史类(全国性加分),628,7,124,118
550,1,文史类(全国性加分),627,11,135,125
551,1,文史类(全国性加分),626,8,143,136
552,1,文史类(全国性加分),625,10,153,144
553,1,文史类(全国性加分),624,7,160,154
554,1,文史类(全国性加分),623,13,173,161
555,1,文史类(全国性加分),622,7,180,174
556,1,文史类(全国性加分),621,7,187,181
557,1,文史类(全国性加分),620,15,202,188
558,1,文史类(全国性加分),619,10,212,203
559,1,文史类(全国性加分),618,14,226,213
560,1,文史类(全国性加分),617,13,239,227
561,1,文史类(全国性加分),616,13,252,240
562,1,文史类(全国性加分),615,17,269,253
563,1,文史类(全国性加分),614,13,282,270
564,1,文史类(全国性加分),613,26,308,283
565,1,文史类(全国性加分),612,12,320,309
566,1,文史类(全国性加分),611,14,334,321
567,1,文史类(全国性加分),610,14,348,335
568,1,文史类(全国性加分),609,16,364,349
569,1,文史类(全国性加分),608,14,378,365
570,1,文史类(全国性加分),607,10,388,379
571,1,文史类(全国性加分),606,23,411,389
572,1,文史类(全国性加分),605,19,430,412
573,1,文史类(全国性加分),604,16,446,431
574,1,文史类(全国性加分),603,20,466,447
575,1,文史类(全国性加分),602,22,488,467
576,1,文史类(全国性加分),601,24,512,489
577,1,文史类(全国性加分),600,20,532,513
578,1,文史类(全国性加分),599,23,555,533
579,1,文史类(全国性加分),598,17,572,556
580,1,文史类(全国性加分),597,23,595,573
581,1,文史类(全国性加分),596,28,623,596
582,1,文史类(全国性加分),595,23,646,624
583,1,文史类(全国性加分),594,25,671,647
584,1,文史类(全国性加分),593,34,705,672
585,1,文史类(全国性加分),592,33,738,706
586,1,文史类(全国性加分),591,26,764,739
587,1,文史类(全国性加分),590,21,785,765
588,1,文史类(全国性加分),589,29,814,786
589,1,文史类(全国性加分),588,35,849,815
590,1,文史类(全国性加分),587,34,883,850
591,1,文史类(全国性加分),586,29,912,884
592,1,文史类(全国性加分),585,28,940,913
593,1,文史类(全国性加分),584,34,974,941
594,1,文史类(全国性加分),583,36,1010,975
595,1,文史类(全国性加分),582,46,1056,1011
596,1,文史类(全国性加分),581,36,1092,1057
597,1,文史类(全国性加分),580,37,1129,1093
598,1,文史类(全国性加分),579,56,1185,1130
599,1,文史类(全国性加分),578,39,1224,1186
600,1,文史类(全国性加分),577,34,1258,1225
601,1,文史类(全国性加分),576,50,1308,1259
602,1,文史类(全国性加分),575,38,1346,1309
603,1,文史类(全国性加分),574,47,1393,1347
604,1,文史类(全国性加分),573,50,1443,1394
605,1,文史类(全国性加分),572,51,1494,1444
606,1,文史类(全国性加分),571,44,1538,1495
607,1,文史类(全国性加分),570,50,1588,1539
608,1,文史类(全国性加分),569,46,1634,1589
609,1,文史类(全国性加分),568,58,1692,1635
610,1,文史类(全国性加分),567,62,1754,1693
611,1,文史类(全国性加分),566,52,1806,1755
612,1,文史类(全国性加分),565,51,1857,1807
613,1,文史类(全国性加分),564,81,1938,1858
614,1,文史类(全国性加分),563,55,1993,1939
615,1,文史类(全国性加分),562,57,2050,1994
616,1,文史类(全国性加分),561,76,2126,2051
617,1,文史类(全国性加分),560,73,2199,2127
618,1,文史类(全国性加分),559,60,2259,2200
619,1,文史类(全国性加分),558,68,2327,2260
620,1,文史类(全国性加分),557,63,2390,2328
621,1,文史类(全国性加分),556,92,2482,2391
622,1,文史类(全国性加分),555,71,2553,2483
623,1,文史类(全国性加分),554,81,2634,2554
624,1,文史类(全国性加分),553,71,2705,2635
625,1,文史类(全国性加分),552,77,2782,2706
626,1,文史类(全国性加分),551,76,2858,2783
627,1,文史类(全国性加分),550,77,2935,2859
628,1,文史类(全国性加分),549,93,3028,2936
629,1,文史类(全国性加分),548,91,3119,3029
630,1,文史类(全国性加分),547,103,3222,3120
631,1,文史类(全国性加分),546,88,3310,3223
632,1,文史类(全国性加分),545,112,3422,3311
633,1,文史类(全国性加分),544,82,3504,3423
634,1,文史类(全国性加分),543,85,3589,3505
635,1,文史类(全国性加分),542,105,3694,3590
636,1,文史类(全国性加分),541,99,3793,3695
637,1,文史类(全国性加分),540,92,3885,3794
638,1,文史类(全国性加分),539,103,3988,3886
639,1,文史类(全国性加分),538,102,4090,3989
640,1,文史类(全国性加分),537,116,4206,4091
641,1,文史类(全国性加分),536,118,4324,4207
642,1,文史类(全国性加分),535,121,4445,4325
643,1,文史类(全国性加分),534,123,4568,4446
644,1,文史类(全国性加分),533,121,4689,4569
645,1,文史类(全国性加分),532,119,4808,4690
646,1,文史类(全国性加分),531,113,4921,4809
647,1,文史类(全国性加分),530,152,5073,4922
648,1,文史类(全国性加分),529,133,5206,5074
649,1,文史类(全国性加分),528,165,5371,5207
650,1,文史类(全国性加分),527,139,5510,5372
651,1,文史类(全国性加分),526,129,5639,5511
652,1,文史类(全国性加分),525,137,5776,5640
653,1,文史类(全国性加分),524,139,5915,5777
654,1,文史类(全国性加分),523,154,6069,5916
655,1,文史类(全国性加分),522,137,6206,6070
656,1,文史类(全国性加分),521,133,6339,6207
657,1,文史类(全国性加分),520,166,6505,6340
658,1,文史类(全国性加分),519,126,6631,6506
659,1,文史类(全国性加分),518,154,6785,6632
660,1,文史类(全国性加分),517,162,6947,6786
661,1,文史类(全国性加分),516,159,7106,6948
662,1,文史类(全国性加分),515,160,7266,7107
663,1,文史类(全国性加分),514,160,7426,7267
664,1,文史类(全国性加分),513,167,7593,7427
665,1,文史类(全国性加分),512,160,7753,7594
666,1,文史类(全国性加分),511,151,7904,7754
667,1,文史类(全国性加分),510,168,8072,7905
668,1,文史类(全国性加分),509,159,8231,8073
669,1,文史类(全国性加分),508,152,8383,8232
670,1,文史类(全国性加分),507,161,8544,8384
671,1,文史类(全国性加分),506,168,8712,8545
672,1,文史类(全国性加分),505,180,8892,8713
673,1,文史类(全国性加分),504,187,9079,8893
674,1,文史类(全国性加分),503,176,9255,9080
675,1,文史类(全国性加分),502,192,9447,9256
676,1,文史类(全国性加分),501,172,9619,9448
677,1,文史类(全国性加分),500,179,9798,9620
678,1,文史类(全国性加分),499,194,9992,9799
679,1,文史类(全国性加分),498,185,10177,9993
680,1,文史类(全国性加分),497,218,10395,10178
681,1,文史类(全国性加分),496,188,10583,10396
682,1,文史类(全国性加分),495,187,10770,10584
683,1,文史类(全国性加分),494,209,10979,10771
684,1,文史类(全国性加分),493,208,11187,10980
685,1,文史类(全国性加分),492,186,11373,11188
686,1,文史类(全国性加分),491,223,11596,11374
687,1,文史类(全国性加分),490,220,11816,11597
688,1,文史类(全国性加分),489,217,12033,11817
689,1,文史类(全国性加分),488,193,12226,12034
690,1,文史类(全国性加分),487,235,12461,12227
691,1,文史类(全国性加分),486,241,12702,12462
692,1,文史类(全国性加分),485,231,12933,12703
693,1,文史类(全国性加分),484,170,13103,12934
694,1,文史类(全国性加分),483,236,13339,13104
695,1,文史类(全国性加分),482,245,13584,13340
696,1,文史类(全国性加分),481,232,13816,13585
697,1,文史类(全国性加分),480,226,14042,13817
698,1,文史类(全国性加分),479,248,14290,14043
699,1,文史类(全国性加分),478,242,14532,14291
700,1,文史类(全国性加分),477,244,14776,14533
701,1,文史类(全国性加分),476,249,15025,14777
702,1,文史类(全国性加分),475,233,15258,15026
703,1,文史类(全国性加分),474,232,15490,15259
704,1,文史类(全国性加分),473,243,15733,15491
705,1,文史类(全国性加分),472,243,15976,15734
706,1,文史类(全国性加分),471,261,16237,15977
707,1,文史类(全国性加分),470,265,16502,16238
708,1,文史类(全国性加分),469,266,16768,16503
709,1,文史类(全国性加分),468,249,17017,16769
710,1,文史类(全国性加分),467,244,17261,17018
711,1,文史类(全国性加分),466,287,17548,17262
712,1,文史类(全国性加分),465,283,17831,17549
713,1,文史类(全国性加分),464,291,18122,17832
714,1,文史类(全国性加分),463,266,18388,18123
715,1,文史类(全国性加分),462,275,18663,18389
716,1,文史类(全国性加分),461,274,18937,18664
717,1,文史类(全国性加分),460,278,19215,18938
718,1,文史类(全国性加分),459,284,19499,19216
719,1,文史类(全国性加分),458,295,19794,19500
720,1,文史类(全国性加分),457,289,20083,19795
721,1,文史类(全国性加分),456,302,20385,20084
722,1,文史类(全国性加分),455,298,20683,20386
723,1,文史类(全国性加分),454,274,20957,20684
724,1,文史类(全国性加分),453,293,21250,20958
725,1,文史类(全国性加分),452,309,21559,21251
726,1,文史类(全国性加分),451,328,21887,21560
727,1,文史类(全国性加分),450,370,22257,21888
728,1,文史类(全国性加分),449,328,22585,22258
729,1,文史类(全国性加分),448,311,22896,22586
730,1,文史类(全国性加分),447,348,23244,22897
731,1,文史类(全国性加分),446,336,23580,23245
732,1,文史类(全国性加分),445,350,23930,23581
733,1,文史类(全国性加分),444,325,24255,23931
734,1,文史类(全国性加分),443,369,24624,24256
735,1,文史类(全国性加分),442,330,24954,24625
736,1,文史类(全国性加分),441,330,25284,24955
737,1,文史类(全国性加分),440,339,25623,25285
738,1,文史类(全国性加分),439,346,25969,25624
739,1,文史类(全国性加分),438,356,26325,25970
740,1,文史类(全国性加分),437,344,26669,26326
741,1,文史类(全国性加分),436,341,27010,26670
742,1,文史类(全国性加分),435,358,27368,27011
743,1,文史类(全国性加分),434,351,27719,27369
744,1,文史类(全国性加分),433,364,28083,27720
745,1,文史类(全国性加分),432,359,28442,28084
746,1,文史类(全国性加分),431,370,28812,28443
747,1,文史类(全国性加分),430,349,29161,28813
748,1,文史类(全国性加分),429,376,29537,29162
749,1,文史类(全国性加分),428,370,29907,29538
750,1,文史类(全国性加分),427,367,30274,29908
751,1,文史类(全国性加分),426,376,30650,30275
752,1,文史类(全国性加分),425,409,31059,30651
753,1,文史类(全国性加分),424,400,31459,31060
754,1,文史类(全国性加分),423,425,31884,31460
755,1,文史类(全国性加分),422,399,32283,31885
756,1,文史类(全国性加分),421,419,32702,32284
757,1,文史类(全国性加分),420,395,33097,32703
758,1,文史类(全国性加分),419,400,33497,33098
759,1,文史类(全国性加分),418,419,33916,33498
760,1,文史类(全国性加分),417,383,34299,33917
761,1,文史类(全国性加分),416,422,34721,34300
762,1,文史类(全国性加分),415,391,35112,34722
763,1,文史类(全国性加分),414,381,35493,35113
764,1,文史类(全国性加分),413,446,35939,35494
765,1,文史类(全国性加分),412,417,36356,35940
766,1,文史类(全国性加分),411,435,36791,36357
767,1,文史类(全国性加分),410,438,37229,36792
768,1,文史类(全国性加分),409,427,37656,37230
769,1,文史类(全国性加分),408,441,38097,37657
770,1,文史类(全国性加分),407,427,38524,38098
771,1,文史类(全国性加分),406,431,38955,38525
772,1,文史类(全国性加分),405,461,39416,38956
773,1,文史类(全国性加分),404,468,39884,39417
774,1,文史类(全国性加分),403,455,40339,39885
775,1,文史类(全国性加分),402,456,40795,40340
776,1,文史类(全国性加分),401,467,41262,40796
777,1,文史类(全国性加分),400,443,41705,41263
778,1,文史类(全国性加分),399,489,42194,41706
779,1,文史类(全国性加分),398,452,42646,42195
780,1,文史类(全国性加分),397,446,43092,42647
781,1,文史类(全国性加分),396,499,43591,43093
782,1,文史类(全国性加分),395,494,44085,43592
783,1,文史类(全国性加分),394,470,44555,44086
784,1,文史类(全国性加分),393,477,45032,44556
785,1,文史类(全国性加分),392,500,45532,45033
786,1,文史类(全国性加分),391,478,46010,45533
787,1,文史类(全国性加分),390,475,46485,46011
788,1,文史类(全国性加分),389,508,46993,46486
789,1,文史类(全国性加分),388,523,47516,46994
790,1,文史类(全国性加分),387,481,47997,47517
791,1,文史类(全国性加分),386,515,48512,47998
792,1,文史类(全国性加分),385,485,48997,48513
793,1,文史类(全国性加分),384,487,49484,48998
794,1,文史类(全国性加分),383,517,50001,49485
795,1,文史类(全国性加分),382,496,50497,50002
796,1,文史类(全国性加分),381,512,51009,50498
797,1,文史类(全国性加分),380,539,51548,51010
798,1,文史类(全国性加分),379,505,52053,51549
799,1,文史类(全国性加分),378,542,52595,52054
800,1,文史类(全国性加分),377,511,53106,52596
801,1,文史类(全国性加分),376,516,53622,53107
802,1,文史类(全国性加分),375,544,54166,53623
803,1,文史类(全国性加分),374,535,54701,54167
804,1,文史类(全国性加分),373,512,55213,54702
805,1,文史类(全国性加分),372,550,55763,55214
806,1,文史类(全国性加分),371,517,56280,55764
807,1,文史类(全国性加分),370,528,56808,56281
808,1,文史类(全国性加分),369,560,57368,56809
809,1,文史类(全国性加分),368,578,57946,57369
810,1,文史类(全国性加分),367,556,58502,57947
811,1,文史类(全国性加分),366,496,58998,58503
812,1,文史类(全国性加分),365,587,59585,58999
813,1,文史类(全国性加分),364,493,60078,59586
814,1,文史类(全国性加分),363,525,60603,60079
815,1,文史类(全国性加分),362,572,61175,60604
816,1,文史类(全国性加分),361,572,61747,61176
817,1,文史类(全国性加分),360,541,62288,61748
818,1,文史类(全国性加分),359,559,62847,62289
819,1,文史类(全国性加分),358,525,63372,62848
820,1,文史类(全国性加分),357,566,63938,63373
821,1,文史类(全国性加分),356,548,64486,63939
822,1,文史类(全国性加分),355,543,65029,64487
823,1,文史类(全国性加分),354,573,65602,65030
824,1,文史类(全国性加分),353,568,66170,65603
825,1,文史类(全国性加分),352,508,66678,66171
826,1,文史类(全国性加分),351,539,67217,66679
827,1,文史类(全国性加分),350,549,67766,67218
828,1,文史类(全国性加分),349,573,68339,67767
829,1,文史类(全国性加分),348,562,68901,68340
830,1,文史类(全国性加分),347,604,69505,68902
831,1,文史类(全国性加分),346,583,70088,69506
832,1,文史类(全国性加分),345,585,70673,70089
833,1,文史类(全国性加分),344,568,71241,70674
834,1,文史类(全国性加分),343,566,71807,71242
835,1,文史类(全国性加分),342,590,72397,71808
836,1,文史类(全国性加分),341,578,72975,72398
837,1,文史类(全国性加分),340,559,73534,72976
838,1,文史类(全国性加分),339,576,74110,73535
839,1,文史类(全国性加分),338,598,74708,74111
840,1,文史类(全国性加分),337,518,75226,74709
841,1,文史类(全国性加分),336,586,75812,75227
842,1,文史类(全国性加分),335,599,76411,75813
843,1,文史类(全国性加分),334,551,76962,76412
844,1,文史类(全国性加分),333,587,77549,76963
845,1,文史类(全国性加分),332,582,78131,77550
846,1,文史类(全国性加分),331,564,78695,78132
847,1,文史类(全国性加分),330,601,79296,78696
848,1,文史类(全国性加分),329,570,79866,79297
849,1,文史类(全国性加分),328,546,80412,79867
850,1,文史类(全国性加分),327,546,80958,80413
851,1,文史类(全国性加分),326,582,81540,80959
852,1,文史类(全国性加分),325,567,82107,81541
853,1,文史类(全国性加分),324,586,82693,82108
854,1,文史类(全国性加分),323,600,83293,82694
855,1,文史类(全国性加分),322,550,83843,83294
856,1,文史类(全国性加分),321,561,84404,83844
857,1,文史类(全国性加分),320,556,84960,84405
858,1,文史类(全国性加分),319,616,85576,84961
859,1,文史类(全国性加分),318,540,86116,85577
860,1,文史类(全国性加分),317,549,86665,86117
861,1,文史类(全国性加分),316,537,87202,86666
862,1,文史类(全国性加分),315,574,87776,87203
863,1,文史类(全国性加分),314,568,88344,87777
864,1,文史类(全国性加分),313,526,88870,88345
865,1,文史类(全国性加分),312,524,89394,88871
866,1,文史类(全国性加分),311,542,89936,89395
867,1,文史类(全国性加分),310,543,90479,89937
868,1,文史类(全国性加分),309,503,90982,90480
869,1,文史类(全国性加分),308,521,91503,90983
870,1,文史类(全国性加分),307,560,92063,91504
871,1,文史类(全国性加分),306,571,92634,92064
872,1,文史类(全国性加分),305,543,93177,92635
873,1,文史类(全国性加分),304,556,93733,93178
874,1,文史类(全国性加分),303,603,94336,93734
875,1,文史类(全国性加分),302,520,94856,94337
876,1,文史类(全国性加分),301,543,95399,94857
877,1,文史类(全国性加分),300,515,95914,95400
878,1,文史类(全国性加分),299,518,96432,95915
879,1,文史类(全国性加分),298,510,96942,96433
880,1,文史类(全国性加分),297,502,97444,96943
881,1,文史类(全国性加分),296,538,97982,97445
882,1,文史类(全国性加分),295,511,98493,97983
883,1,文史类(全国性加分),294,533,99026,98494
884,1,文史类(全国性加分),293,530,99556,99027
885,1,文史类(全国性加分),292,498,100054,99557
886,1,文史类(全国性加分),291,486,100540,100055
887,1,文史类(全国性加分),290,419,100959,100541
888,1,文史类(全国性加分),289,494,101453,100960
889,1,文史类(全国性加分),288,506,101959,101454
890,1,文史类(全国性加分),287,455,102414,101960
891,1,文史类(全国性加分),286,451,102865,102415
892,1,文史类(全国性加分),285,445,103310,102866
893,1,文史类(全国性加分),284,478,103788,103311
894,1,文史类(全国性加分),283,462,104250,103789
895,1,文史类(全国性加分),282,487,104737,104251
896,1,文史类(全国性加分),281,447,105184,104738
897,1,文史类(全国性加分),280,422,105606,105185
898,1,文史类(全国性加分),279,458,106064,105607
899,1,文史类(全国性加分),278,457,106521,106065
900,1,文史类(全国性加分),277,454,106975,106522
901,1,文史类(全国性加分),276,451,107426,106976
902,1,文史类(全国性加分),275,416,107842,107427
903,1,文史类(全国性加分),274,431,108273,107843
904,1,文史类(全国性加分),273,430,108703,108274
905,1,文史类(全国性加分),272,408,109111,108704
906,1,文史类(全国性加分),271,376,109487,109112
907,1,文史类(全国性加分),270,399,109886,109488
908,1,文史类(全国性加分),269,423,110309,109887
909,1,文史类(全国性加分),268,352,110661,110310
910,1,文史类(全国性加分),267,409,111070,110662
911,1,文史类(全国性加分),266,374,111444,111071
912,1,文史类(全国性加分),265,362,111806,111445
913,1,文史类(全国性加分),264,355,112161,111807
914,1,文史类(全国性加分),263,367,112528,112162
915,1,文史类(全国性加分),262,343,112871,112529
916,1,文史类(全国性加分),261,350,113221,112872
917,1,文史类(全国性加分),260,296,113517,113222
918,1,文史类(全国性加分),259,334,113851,113518
919,1,文史类(全国性加分),258,351,114202,113852
920,1,文史类(全国性加分),257,330,114532,114203
921,1,文史类(全国性加分),256,336,114868,114533
922,1,文史类(全国性加分),255,298,115166,114869
923,1,文史类(全国性加分),254,318,115484,115167
924,1,文史类(全国性加分),253,352,115836,115485
925,1,文史类(全国性加分),252,321,116157,115837
926,1,文史类(全国性加分),251,281,116438,116158
927,1,文史类(全国性加分),250,280,116718,116439
928,1,文史类(全国性加分),249,291,117009,116719
929,1,文史类(全国性加分),248,267,117276,117010
930,1,文史类(全国性加分),247,294,117570,117277
931,1,文史类(全国性加分),246,278,117848,117571
932,1,文史类(全国性加分),245,269,118117,117849
933,1,文史类(全国性加分),244,281,118398,118118
934,1,文史类(全国性加分),243,277,118675,118399
935,1,文史类(全国性加分),242,251,118926,118676
936,1,文史类(全国性加分),241,248,119174,118927
937,1,文史类(全国性加分),240,252,119426,119175
938,1,文史类(全国性加分),239,222,119648,119427
939,1,文史类(全国性加分),238,207,119855,119649
940,1,文史类(全国性加分),237,224,120079,119856
941,1,文史类(全国性加分),236,229,120308,120080
942,1,文史类(全国性加分),235,201,120509,120309
943,1,文史类(全国性加分),234,224,120733,120510
944,1,文史类(全国性加分),233,193,120926,120734
945,1,文史类(全国性加分),232,225,121151,120927
946,1,文史类(全国性加分),231,189,121340,121152
947,1,文史类(全国性加分),230,188,121528,121341
948,1,文史类(全国性加分),229,205,121733,121529
949,1,文史类(全国性加分),228,186,121919,121734
950,1,文史类(全国性加分),227,186,122105,121920
951,1,文史类(全国性加分),226,206,122311,122106
952,1,文史类(全国性加分),225,160,122471,122312
953,1,文史类(全国性加分),224,165,122636,122472
954,1,文史类(全国性加分),223,185,122821,122637
955,1,文史类(全国性加分),222,161,122982,122822
956,1,文史类(全国性加分),221,146,123128,122983
957,1,文史类(全国性加分),220,123,123251,123129
958,1,文史类(全国性加分),219,138,123389,123252
959,1,文史类(全国性加分),218,132,123521,123390
960,1,文史类(全国性加分),217,133,123654,123522
961,1,文史类(全国性加分),216,137,123791,123655
962,1,文史类(全国性加分),215,145,123936,123792
963,1,文史类(全国性加分),214,118,124054,123937
964,1,文史类(全国性加分),213,114,124168,124055
965,1,文史类(全国性加分),212,122,124290,124169
966,1,文史类(全国性加分),211,127,124417,124291
967,1,文史类(全国性加分),210,109,124526,124418
968,1,文史类(全国性加分),209,89,124615,124527
969,1,文史类(全国性加分),208,123,124738,124616
970,1,文史类(全国性加分),207,101,124839,124739
971,1,文史类(全国性加分),206,97,124936,124840
972,1,文史类(全国性加分),205,105,125041,124937
973,1,文史类(全国性加分),204,100,125141,125042
974,1,文史类(全国性加分),203,101,125242,125142
975,1,文史类(全国性加分),202,96,125338,125243
976,1,文史类(全国性加分),201,87,125425,125339
977,1,文史类(全国性加分),200,74,125499,125426
978,1,文史类(全国性加分),199,77,125576,125500
979,1,文史类(全国性加分),198,94,125670,125577
980,1,文史类(全国性加分),197,62,125732,125671
981,1,文史类(全国性加分),196,70,125802,125733
982,1,文史类(全国性加分),195,73,125875,125803
983,1,文史类(全国性加分),194,77,125952,125876
984,1,文史类(全国性加分),193,74,126026,125953
985,1,文史类(全国性加分),192,56,126082,126027
986,1,文史类(全国性加分),191,77,126159,126083
987,1,文史类(全国性加分),190,57,126216,126160
988,1,文史类(全国性加分),189,54,126270,126217
989,1,文史类(全国性加分),188,65,126335,126271
990,1,文史类(全国性加分),187,55,126390,126336
991,1,文史类(全国性加分),186,65,126455,126391
992,1,文史类(全国性加分),185,38,126493,126456
993,1,文史类(全国性加分),184,42,126535,126494
994,1,文史类(全国性加分),183,44,126579,126536
995,1,文史类(全国性加分),182,39,126618,126580
996,1,文史类(全国性加分),181,43,126661,126619
997,1,文史类(全国性加分),180,41,126702,126662
998,2,理工类(全国性加分),710,3,13,11
999,2,理工类(全国性加分),709,3,16,14
1000,2,理工类(全国性加分),708,1,17,17
1001,2,理工类(全国性加分),707,1,18,18
1002,2,理工类(全国性加分),706,3,21,19
1003,2,理工类(全国性加分),704,2,23,22
1004,2,理工类(全国性加分),703,2,25,24
1005,2,理工类(全国性加分),702,3,28,26
1006,2,理工类(全国性加分),701,4,32,29
1007,2,理工类(全国性加分),700,4,36,33
1008,2,理工类(全国性加分),699,6,42,37
1009,2,理工类(全国性加分),698,4,46,43
1010,2,理工类(全国性加分),697,9,55,47
1011,2,理工类(全国性加分),696,3,58,56
1012,2,理工类(全国性加分),695,5,63,59
1013,2,理工类(全国性加分),694,13,76,64
1014,2,理工类(全国性加分),693,3,79,77
1015,2,理工类(全国性加分),692,8,87,80
1016,2,理工类(全国性加分),691,5,92,88
1017,2,理工类(全国性加分),690,12,104,93
1018,2,理工类(全国性加分),689,6,110,105
1019,2,理工类(全国性加分),688,16,126,111
1020,2,理工类(全国性加分),687,9,135,127
1021,2,理工类(全国性加分),686,9,144,136
1022,2,理工类(全国性加分),685,19,163,145
1023,2,理工类(全国性加分),684,19,182,164
1024,2,理工类(全国性加分),683,22,204,183
1025,2,理工类(全国性加分),682,18,222,205
1026,2,理工类(全国性加分),681,17,239,223
1027,2,理工类(全国性加分),680,16,255,240
1028,2,理工类(全国性加分),679,9,264,256
1029,2,理工类(全国性加分),678,21,285,265
1030,2,理工类(全国性加分),677,18,303,286
1031,2,理工类(全国性加分),676,22,325,304
1032,2,理工类(全国性加分),675,21,346,326
1033,2,理工类(全国性加分),674,25,371,347
1034,2,理工类(全国性加分),673,29,400,372
1035,2,理工类(全国性加分),672,25,425,401
1036,2,理工类(全国性加分),671,32,457,426
1037,2,理工类(全国性加分),670,33,490,458
1038,2,理工类(全国性加分),669,39,529,491
1039,2,理工类(全国性加分),668,29,558,530
1040,2,理工类(全国性加分),667,37,595,559
1041,2,理工类(全国性加分),666,33,628,596
1042,2,理工类(全国性加分),665,28,656,629
1043,2,理工类(全国性加分),664,36,692,657
1044,2,理工类(全国性加分),663,35,727,693
1045,2,理工类(全国性加分),662,37,764,728
1046,2,理工类(全国性加分),661,46,810,765
1047,2,理工类(全国性加分),660,63,873,811
1048,2,理工类(全国性加分),659,46,919,874
1049,2,理工类(全国性加分),658,43,962,920
1050,2,理工类(全国性加分),657,51,1013,963
1051,2,理工类(全国性加分),656,60,1073,1014
1052,2,理工类(全国性加分),655,64,1137,1074
1053,2,理工类(全国性加分),654,71,1208,1138
1054,2,理工类(全国性加分),653,67,1275,1209
1055,2,理工类(全国性加分),652,56,1331,1276
1056,2,理工类(全国性加分),651,62,1393,1332
1057,2,理工类(全国性加分),650,69,1462,1394
1058,2,理工类(全国性加分),649,68,1530,1463
1059,2,理工类(全国性加分),648,73,1603,1531
1060,2,理工类(全国性加分),647,91,1694,1604
1061,2,理工类(全国性加分),646,75,1769,1695
1062,2,理工类(全国性加分),645,83,1852,1770
1063,2,理工类(全国性加分),644,71,1923,1853
1064,2,理工类(全国性加分),643,67,1990,1924
1065,2,理工类(全国性加分),642,83,2073,1991
1066,2,理工类(全国性加分),641,93,2166,2074
1067,2,理工类(全国性加分),640,67,2233,2167
1068,2,理工类(全国性加分),639,85,2318,2234
1069,2,理工类(全国性加分),638,85,2403,2319
1070,2,理工类(全国性加分),637,107,2510,2404
1071,2,理工类(全国性加分),636,111,2621,2511
1072,2,理工类(全国性加分),635,87,2708,2622
1073,2,理工类(全国性加分),634,89,2797,2709
1074,2,理工类(全国性加分),633,106,2903,2798
1075,2,理工类(全国性加分),632,95,2998,2904
1076,2,理工类(全国性加分),631,117,3115,2999
1077,2,理工类(全国性加分),630,108,3223,3116
1078,2,理工类(全国性加分),629,102,3325,3224
1079,2,理工类(全国性加分),628,121,3446,3326
1080,2,理工类(全国性加分),627,138,3584,3447
1081,2,理工类(全国性加分),626,128,3712,3585
1082,2,理工类(全国性加分),625,104,3816,3713
1083,2,理工类(全国性加分),624,122,3938,3817
1084,2,理工类(全国性加分),623,134,4072,3939
1085,2,理工类(全国性加分),622,134,4206,4073
1086,2,理工类(全国性加分),621,141,4347,4207
1087,2,理工类(全国性加分),620,122,4469,4348
1088,2,理工类(全国性加分),619,127,4596,4470
1089,2,理工类(全国性加分),618,133,4729,4597
1090,2,理工类(全国性加分),617,153,4882,4730
1091,2,理工类(全国性加分),616,154,5036,4883
1092,2,理工类(全国性加分),615,133,5169,5037
1093,2,理工类(全国性加分),614,156,5325,5170
1094,2,理工类(全国性加分),613,146,5471,5326
1095,2,理工类(全国性加分),612,171,5642,5472
1096,2,理工类(全国性加分),611,143,5785,5643
1097,2,理工类(全国性加分),610,159,5944,5786
1098,2,理工类(全国性加分),609,172,6116,5945
1099,2,理工类(全国性加分),608,182,6298,6117
1100,2,理工类(全国性加分),607,168,6466,6299
1101,2,理工类(全国性加分),606,179,6645,6467
1102,2,理工类(全国性加分),605,179,6824,6646
1103,2,理工类(全国性加分),604,199,7023,6825
1104,2,理工类(全国性加分),603,176,7199,7024
1105,2,理工类(全国性加分),602,196,7395,7200
1106,2,理工类(全国性加分),601,169,7564,7396
1107,2,理工类(全国性加分),600,201,7765,7565
1108,2,理工类(全国性加分),599,196,7961,7766
1109,2,理工类(全国性加分),598,214,8175,7962
1110,2,理工类(全国性加分),597,198,8373,8176
1111,2,理工类(全国性加分),596,196,8569,8374
1112,2,理工类(全国性加分),595,199,8768,8570
1113,2,理工类(全国性加分),594,197,8965,8769
1114,2,理工类(全国性加分),593,219,9184,8966
1115,2,理工类(全国性加分),592,197,9381,9185
1116,2,理工类(全国性加分),591,214,9595,9382
1117,2,理工类(全国性加分),590,211,9806,9596
1118,2,理工类(全国性加分),589,208,10014,9807
1119,2,理工类(全国性加分),588,218,10232,10015
1120,2,理工类(全国性加分),587,236,10468,10233
1121,2,理工类(全国性加分),586,242,10710,10469
1122,2,理工类(全国性加分),585,239,10949,10711
1123,2,理工类(全国性加分),584,254,11203,10950
1124,2,理工类(全国性加分),583,246,11449,11204
1125,2,理工类(全国性加分),582,241,11690,11450
1126,2,理工类(全国性加分),581,264,11954,11691
1127,2,理工类(全国性加分),580,264,12218,11955
1128,2,理工类(全国性加分),579,229,12447,12219
1129,2,理工类(全国性加分),578,254,12701,12448
1130,2,理工类(全国性加分),577,261,12962,12702
1131,2,理工类(全国性加分),576,259,13221,12963
1132,2,理工类(全国性加分),575,266,13487,13222
1133,2,理工类(全国性加分),574,264,13751,13488
1134,2,理工类(全国性加分),573,286,14037,13752
1135,2,理工类(全国性加分),572,254,14291,14038
1136,2,理工类(全国性加分),571,296,14587,14292
1137,2,理工类(全国性加分),570,289,14876,14588
1138,2,理工类(全国性加分),569,281,15157,14877
1139,2,理工类(全国性加分),568,263,15420,15158
1140,2,理工类(全国性加分),567,291,15711,15421
1141,2,理工类(全国性加分),566,313,16024,15712
1142,2,理工类(全国性加分),565,287,16311,16025
1143,2,理工类(全国性加分),564,310,16621,16312
1144,2,理工类(全国性加分),563,342,16963,16622
1145,2,理工类(全国性加分),562,323,17286,16964
1146,2,理工类(全国性加分),561,327,17613,17287
1147,2,理工类(全国性加分),560,307,17920,17614
1148,2,理工类(全国性加分),559,314,18234,17921
1149,2,理工类(全国性加分),558,305,18539,18235
1150,2,理工类(全国性加分),557,327,18866,18540
1151,2,理工类(全国性加分),556,341,19207,18867
1152,2,理工类(全国性加分),555,349,19556,19208
1153,2,理工类(全国性加分),554,377,19933,19557
1154,2,理工类(全国性加分),553,318,20251,19934
1155,2,理工类(全国性加分),552,333,20584,20252
1156,2,理工类(全国性加分),551,329,20913,20585
1157,2,理工类(全国性加分),550,343,21256,20914
1158,2,理工类(全国性加分),549,312,21568,21257
1159,2,理工类(全国性加分),548,357,21925,21569
1160,2,理工类(全国性加分),547,378,22303,21926
1161,2,理工类(全国性加分),546,351,22654,22304
1162,2,理工类(全国性加分),545,346,23000,22655
1163,2,理工类(全国性加分),544,375,23375,23001
1164,2,理工类(全国性加分),543,393,23768,23376
1165,2,理工类(全国性加分),542,395,24163,23769
1166,2,理工类(全国性加分),541,375,24538,24164
1167,2,理工类(全国性加分),540,385,24923,24539
1168,2,理工类(全国性加分),539,391,25314,24924
1169,2,理工类(全国性加分),538,365,25679,25315
1170,2,理工类(全国性加分),537,360,26039,25680
1171,2,理工类(全国性加分),536,401,26440,26040
1172,2,理工类(全国性加分),535,376,26816,26441
1173,2,理工类(全国性加分),534,419,27235,26817
1174,2,理工类(全国性加分),533,399,27634,27236
1175,2,理工类(全国性加分),532,381,28015,27635
1176,2,理工类(全国性加分),531,396,28411,28016
1177,2,理工类(全国性加分),530,395,28806,28412
1178,2,理工类(全国性加分),529,391,29197,28807
1179,2,理工类(全国性加分),528,380,29577,29198
1180,2,理工类(全国性加分),527,411,29988,29578
1181,2,理工类(全国性加分),526,367,30355,29989
1182,2,理工类(全国性加分),525,421,30776,30356
1183,2,理工类(全国性加分),524,419,31195,30777
1184,2,理工类(全国性加分),523,423,31618,31196
1185,2,理工类(全国性加分),522,417,32035,31619
1186,2,理工类(全国性加分),521,403,32438,32036
1187,2,理工类(全国性加分),520,458,32896,32439
1188,2,理工类(全国性加分),519,461,33357,32897
1189,2,理工类(全国性加分),518,443,33800,33358
1190,2,理工类(全国性加分),517,444,34244,33801
1191,2,理工类(全国性加分),516,439,34683,34245
1192,2,理工类(全国性加分),515,443,35126,34684
1193,2,理工类(全国性加分),514,436,35562,35127
1194,2,理工类(全国性加分),513,376,35938,35563
1195,2,理工类(全国性加分),512,435,36373,35939
1196,2,理工类(全国性加分),511,422,36795,36374
1197,2,理工类(全国性加分),510,441,37236,36796
1198,2,理工类(全国性加分),509,463,37699,37237
1199,2,理工类(全国性加分),508,386,38085,37700
1200,2,理工类(全国性加分),507,408,38493,38086
1201,2,理工类(全国性加分),506,456,38949,38494
1202,2,理工类(全国性加分),505,394,39343,38950
1203,2,理工类(全国性加分),504,483,39826,39344
1204,2,理工类(全国性加分),503,430,40256,39827
1205,2,理工类(全国性加分),502,481,40737,40257
1206,2,理工类(全国性加分),501,464,41201,40738
1207,2,理工类(全国性加分),500,472,41673,41202
1208,2,理工类(全国性加分),499,475,42148,41674
1209,2,理工类(全国性加分),498,450,42598,42149
1210,2,理工类(全国性加分),497,479,43077,42599
1211,2,理工类(全国性加分),496,437,43514,43078
1212,2,理工类(全国性加分),495,425,43939,43515
1213,2,理工类(全国性加分),494,487,44426,43940
1214,2,理工类(全国性加分),493,441,44867,44427
1215,2,理工类(全国性加分),492,461,45328,44868
1216,2,理工类(全国性加分),491,450,45778,45329
1217,2,理工类(全国性加分),490,524,46302,45779
1218,2,理工类(全国性加分),489,438,46740,46303
1219,2,理工类(全国性加分),488,480,47220,46741
1220,2,理工类(全国性加分),487,445,47665,47221
1221,2,理工类(全国性加分),486,462,48127,47666
1222,2,理工类(全国性加分),485,453,48580,48128
1223,2,理工类(全国性加分),484,483,49063,48581
1224,2,理工类(全国性加分),483,484,49547,49064
1225,2,理工类(全国性加分),482,450,49997,49548
1226,2,理工类(全国性加分),481,429,50426,49998
1227,2,理工类(全国性加分),480,459,50885,50427
1228,2,理工类(全国性加分),479,448,51333,50886
1229,2,理工类(全国性加分),478,445,51778,51334
1230,2,理工类(全国性加分),477,472,52250,51779
1231,2,理工类(全国性加分),476,461,52711,52251
1232,2,理工类(全国性加分),475,490,53201,52712
1233,2,理工类(全国性加分),474,513,53714,53202
1234,2,理工类(全国性加分),473,482,54196,53715
1235,2,理工类(全国性加分),472,505,54701,54197
1236,2,理工类(全国性加分),471,497,55198,54702
1237,2,理工类(全国性加分),470,511,55709,55199
1238,2,理工类(全国性加分),469,436,56145,55710
1239,2,理工类(全国性加分),468,472,56617,56146
1240,2,理工类(全国性加分),467,477,57094,56618
1241,2,理工类(全国性加分),466,480,57574,57095
1242,2,理工类(全国性加分),465,507,58081,57575
1243,2,理工类(全国性加分),464,521,58602,58082
1244,2,理工类(全国性加分),463,528,59130,58603
1245,2,理工类(全国性加分),462,499,59629,59131
1246,2,理工类(全国性加分),461,472,60101,59630
1247,2,理工类(全国性加分),460,488,60589,60102
1248,2,理工类(全国性加分),459,512,61101,60590
1249,2,理工类(全国性加分),458,468,61569,61102
1250,2,理工类(全国性加分),457,512,62081,61570
1251,2,理工类(全国性加分),456,510,62591,62082
1252,2,理工类(全国性加分),455,519,63110,62592
1253,2,理工类(全国性加分),454,514,63624,63111
1254,2,理工类(全国性加分),453,590,64214,63625
1255,2,理工类(全国性加分),452,511,64725,64215
1256,2,理工类(全国性加分),451,539,65264,64726
1257,2,理工类(全国性加分),450,531,65795,65265
1258,2,理工类(全国性加分),449,550,66345,65796
1259,2,理工类(全国性加分),448,493,66838,66346
1260,2,理工类(全国性加分),447,502,67340,66839
1261,2,理工类(全国性加分),446,554,67894,67341
1262,2,理工类(全国性加分),445,500,68394,67895
1263,2,理工类(全国性加分),444,523,68917,68395
1264,2,理工类(全国性加分),443,553,69470,68918
1265,2,理工类(全国性加分),442,474,69944,69471
1266,2,理工类(全国性加分),441,558,70502,69945
1267,2,理工类(全国性加分),440,538,71040,70503
1268,2,理工类(全国性加分),439,541,71581,71041
1269,2,理工类(全国性加分),438,544,72125,71582
1270,2,理工类(全国性加分),437,566,72691,72126
1271,2,理工类(全国性加分),436,564,73255,72692
1272,2,理工类(全国性加分),435,588,73843,73256
1273,2,理工类(全国性加分),434,574,74417,73844
1274,2,理工类(全国性加分),433,589,75006,74418
1275,2,理工类(全国性加分),432,528,75534,75007
1276,2,理工类(全国性加分),431,521,76055,75535
1277,2,理工类(全国性加分),430,579,76634,76056
1278,2,理工类(全国性加分),429,539,77173,76635
1279,2,理工类(全国性加分),428,528,77701,77174
1280,2,理工类(全国性加分),427,591,78292,77702
1281,2,理工类(全国性加分),426,534,78826,78293
1282,2,理工类(全国性加分),425,616,79442,78827
1283,2,理工类(全国性加分),424,582,80024,79443
1284,2,理工类(全国性加分),423,556,80580,80025
1285,2,理工类(全国性加分),422,600,81180,80581
1286,2,理工类(全国性加分),421,591,81771,81181
1287,2,理工类(全国性加分),420,591,82362,81772
1288,2,理工类(全国性加分),419,529,82891,82363
1289,2,理工类(全国性加分),418,602,83493,82892
1290,2,理工类(全国性加分),417,565,84058,83494
1291,2,理工类(全国性加分),416,581,84639,84059
1292,2,理工类(全国性加分),415,576,85215,84640
1293,2,理工类(全国性加分),414,590,85805,85216
1294,2,理工类(全国性加分),413,575,86380,85806
1295,2,理工类(全国性加分),412,594,86974,86381
1296,2,理工类(全国性加分),411,576,87550,86975
1297,2,理工类(全国性加分),410,603,88153,87551
1298,2,理工类(全国性加分),409,615,88768,88154
1299,2,理工类(全国性加分),408,574,89342,88769
1300,2,理工类(全国性加分),407,591,89933,89343
1301,2,理工类(全国性加分),406,640,90573,89934
1302,2,理工类(全国性加分),405,601,91174,90574
1303,2,理工类(全国性加分),404,594,91768,91175
1304,2,理工类(全国性加分),403,574,92342,91769
1305,2,理工类(全国性加分),402,638,92980,92343
1306,2,理工类(全国性加分),401,623,93603,92981
1307,2,理工类(全国性加分),400,591,94194,93604
1308,2,理工类(全国性加分),399,600,94794,94195
1309,2,理工类(全国性加分),398,595,95389,94795
1310,2,理工类(全国性加分),397,552,95941,95390
1311,2,理工类(全国性加分),396,582,96523,95942
1312,2,理工类(全国性加分),395,551,97074,96524
1313,2,理工类(全国性加分),394,617,97691,97075
1314,2,理工类(全国性加分),393,651,98342,97692
1315,2,理工类(全国性加分),392,625,98967,98343
1316,2,理工类(全国性加分),391,615,99582,98968
1317,2,理工类(全国性加分),390,647,100229,99583
1318,2,理工类(全国性加分),389,628,100857,100230
1319,2,理工类(全国性加分),388,641,101498,100858
1320,2,理工类(全国性加分),387,622,102120,101499
1321,2,理工类(全国性加分),386,614,102734,102121
1322,2,理工类(全国性加分),385,575,103309,102735
1323,2,理工类(全国性加分),384,668,103977,103310
1324,2,理工类(全国性加分),383,625,104602,103978
1325,2,理工类(全国性加分),382,613,105215,104603
1326,2,理工类(全国性加分),381,607,105822,105216
1327,2,理工类(全国性加分),380,629,106451,105823
1328,2,理工类(全国性加分),379,642,107093,106452
1329,2,理工类(全国性加分),378,634,107727,107094
1330,2,理工类(全国性加分),377,601,108328,107728
1331,2,理工类(全国性加分),376,582,108910,108329
1332,2,理工类(全国性加分),375,643,109553,108911
1333,2,理工类(全国性加分),374,658,110211,109554
1334,2,理工类(全国性加分),373,639,110850,110212
1335,2,理工类(全国性加分),372,662,111512,110851
1336,2,理工类(全国性加分),371,647,112159,111513
1337,2,理工类(全国性加分),370,616,112775,112160
1338,2,理工类(全国性加分),369,678,113453,112776
1339,2,理工类(全国性加分),368,602,114055,113454
1340,2,理工类(全国性加分),367,601,114656,114056
1341,2,理工类(全国性加分),366,623,115279,114657
1342,2,理工类(全国性加分),365,563,115842,115280
1343,2,理工类(全国性加分),364,589,116431,115843
1344,2,理工类(全国性加分),363,615,117046,116432
1345,2,理工类(全国性加分),362,642,117688,117047
1346,2,理工类(全国性加分),361,617,118305,117689
1347,2,理工类(全国性加分),360,555,118860,118306
1348,2,理工类(全国性加分),359,617,119477,118861
1349,2,理工类(全国性加分),358,591,120068,119478
1350,2,理工类(全国性加分),357,608,120676,120069
1351,2,理工类(全国性加分),356,673,121349,120677
1352,2,理工类(全国性加分),355,605,121954,121350
1353,2,理工类(全国性加分),354,587,122541,121955
1354,2,理工类(全国性加分),353,620,123161,122542
1355,2,理工类(全国性加分),352,605,123766,123162
1356,2,理工类(全国性加分),351,610,124376,123767
1357,2,理工类(全国性加分),350,594,124970,124377
1358,2,理工类(全国性加分),349,593,125563,124971
1359,2,理工类(全国性加分),348,590,126153,125564
1360,2,理工类(全国性加分),347,609,126762,126154
1361,2,理工类(全国性加分),346,620,127382,126763
1362,2,理工类(全国性加分),345,564,127946,127383
1363,2,理工类(全国性加分),344,610,128556,127947
1364,2,理工类(全国性加分),343,609,129165,128557
1365,2,理工类(全国性加分),342,592,129757,129166
1366,2,理工类(全国性加分),341,579,130336,129758
1367,2,理工类(全国性加分),340,608,130944,130337
1368,2,理工类(全国性加分),339,583,131527,130945
1369,2,理工类(全国性加分),338,567,132094,131528
1370,2,理工类(全国性加分),337,581,132675,132095
1371,2,理工类(全国性加分),336,557,133232,132676
1372,2,理工类(全国性加分),335,576,133808,133233
1373,2,理工类(全国性加分),334,584,134392,133809
1374,2,理工类(全国性加分),333,571,134963,134393
1375,2,理工类(全国性加分),332,582,135545,134964
1376,2,理工类(全国性加分),331,577,136122,135546
1377,2,理工类(全国性加分),330,590,136712,136123
1378,2,理工类(全国性加分),329,614,137326,136713
1379,2,理工类(全国性加分),328,585,137911,137327
1380,2,理工类(全国性加分),327,598,138509,137912
1381,2,理工类(全国性加分),326,558,139067,138510
1382,2,理工类(全国性加分),325,580,139647,139068
1383,2,理工类(全国性加分),324,534,140181,139648
1384,2,理工类(全国性加分),323,534,140715,140182
1385,2,理工类(全国性加分),322,581,141296,140716
1386,2,理工类(全国性加分),321,559,141855,141297
1387,2,理工类(全国性加分),320,533,142388,141856
1388,2,理工类(全国性加分),319,536,142924,142389
1389,2,理工类(全国性加分),318,512,143436,142925
1390,2,理工类(全国性加分),317,541,143977,143437
1391,2,理工类(全国性加分),316,538,144515,143978
1392,2,理工类(全国性加分),315,540,145055,144516
1393,2,理工类(全国性加分),314,504,145559,145056
1394,2,理工类(全国性加分),313,536,146095,145560
1395,2,理工类(全国性加分),312,533,146628,146096
1396,2,理工类(全国性加分),311,520,147148,146629
1397,2,理工类(全国性加分),310,523,147671,147149
1398,2,理工类(全国性加分),309,535,148206,147672
1399,2,理工类(全国性加分),308,492,148698,148207
1400,2,理工类(全国性加分),307,525,149223,148699
1401,2,理工类(全国性加分),306,522,149745,149224
1402,2,理工类(全国性加分),305,473,150218,149746
1403,2,理工类(全国性加分),304,532,150750,150219
1404,2,理工类(全国性加分),303,482,151232,150751
1405,2,理工类(全国性加分),302,533,151765,151233
1406,2,理工类(全国性加分),301,494,152259,151766
1407,2,理工类(全国性加分),300,489,152748,152260
1408,2,理工类(全国性加分),299,500,153248,152749
1409,2,理工类(全国性加分),298,502,153750,153249
1410,2,理工类(全国性加分),297,485,154235,153751
1411,2,理工类(全国性加分),296,470,154705,154236
1412,2,理工类(全国性加分),295,500,155205,154706
1413,2,理工类(全国性加分),294,477,155682,155206
1414,2,理工类(全国性加分),293,520,156202,155683
1415,2,理工类(全国性加分),292,474,156676,156203
1416,2,理工类(全国性加分),291,463,157139,156677
1417,2,理工类(全国性加分),290,466,157605,157140
1418,2,理工类(全国性加分),289,472,158077,157606
1419,2,理工类(全国性加分),288,499,158576,158078
1420,2,理工类(全国性加分),287,462,159038,158577
1421,2,理工类(全国性加分),286,482,159520,159039
1422,2,理工类(全国性加分),285,446,159966,159521
1423,2,理工类(全国性加分),284,422,160388,159967
1424,2,理工类(全国性加分),283,457,160845,160389
1425,2,理工类(全国性加分),282,439,161284,160846
1426,2,理工类(全国性加分),281,460,161744,161285
1427,2,理工类(全国性加分),280,424,162168,161745
1428,2,理工类(全国性加分),279,428,162596,162169
1429,2,理工类(全国性加分),278,430,163026,162597
1430,2,理工类(全国性加分),277,451,163477,163027
1431,2,理工类(全国性加分),276,420,163897,163478
1432,2,理工类(全国性加分),275,417,164314,163898
1433,2,理工类(全国性加分),274,434,164748,164315
1434,2,理工类(全国性加分),273,439,165187,164749
1435,2,理工类(全国性加分),272,413,165600,165188
1436,2,理工类(全国性加分),271,409,166009,165601
1437,2,理工类(全国性加分),270,405,166414,166010
1438,2,理工类(全国性加分),269,445,166859,166415
1439,2,理工类(全国性加分),268,417,167276,166860
1440,2,理工类(全国性加分),267,393,167669,167277
1441,2,理工类(全国性加分),266,410,168079,167670
1442,2,理工类(全国性加分),265,368,168447,168080
1443,2,理工类(全国性加分),264,437,168884,168448
1444,2,理工类(全国性加分),263,405,169289,168885
1445,2,理工类(全国性加分),262,372,169661,169290
1446,2,理工类(全国性加分),261,391,170052,169662
1447,2,理工类(全国性加分),260,372,170424,170053
1448,2,理工类(全国性加分),259,384,170808,170425
1449,2,理工类(全国性加分),258,355,171163,170809
1450,2,理工类(全国性加分),257,367,171530,171164
1451,2,理工类(全国性加分),256,360,171890,171531
1452,2,理工类(全国性加分),255,390,172280,171891
1453,2,理工类(全国性加分),254,332,172612,172281
1454,2,理工类(全国性加分),253,362,172974,172613
1455,2,理工类(全国性加分),252,354,173328,172975
1456,2,理工类(全国性加分),251,353,173681,173329
1457,2,理工类(全国性加分),250,333,174014,173682
1458,2,理工类(全国性加分),249,320,174334,174015
1459,2,理工类(全国性加分),248,384,174718,174335
1460,2,理工类(全国性加分),247,349,175067,174719
1461,2,理工类(全国性加分),246,331,175398,175068
1462,2,理工类(全国性加分),245,314,175712,175399
1463,2,理工类(全国性加分),244,346,176058,175713
1464,2,理工类(全国性加分),243,344,176402,176059
1465,2,理工类(全国性加分),242,324,176726,176403
1466,2,理工类(全国性加分),241,292,177018,176727
1467,2,理工类(全国性加分),240,306,177324,177019
1468,2,理工类(全国性加分),239,298,177622,177325
1469,2,理工类(全国性加分),238,317,177939,177623
1470,2,理工类(全国性加分),237,326,178265,177940
1471,2,理工类(全国性加分),236,316,178581,178266
1472,2,理工类(全国性加分),235,299,178880,178582
1473,2,理工类(全国性加分),234,310,179190,178881
1474,2,理工类(全国性加分),233,289,179479,179191
1475,2,理工类(全国性加分),232,292,179771,179480
1476,2,理工类(全国性加分),231,269,180040,179772
1477,2,理工类(全国性加分),230,253,180293,180041
1478,2,理工类(全国性加分),229,291,180584,180294
1479,2,理工类(全国性加分),228,253,180837,180585
1480,2,理工类(全国性加分),227,299,181136,180838
1481,2,理工类(全国性加分),226,268,181404,181137
1482,2,理工类(全国性加分),225,260,181664,181405
1483,2,理工类(全国性加分),224,271,181935,181665
1484,2,理工类(全国性加分),223,285,182220,181936
1485,2,理工类(全国性加分),222,229,182449,182221
1486,2,理工类(全国性加分),221,267,182716,182450
1487,2,理工类(全国性加分),220,255,182971,182717
1488,2,理工类(全国性加分),219,227,183198,182972
1489,2,理工类(全国性加分),218,259,183457,183199
1490,2,理工类(全国性加分),217,233,183690,183458
1491,2,理工类(全国性加分),216,214,183904,183691
1492,2,理工类(全国性加分),215,237,184141,183905
1493,2,理工类(全国性加分),214,256,184397,184142
1494,2,理工类(全国性加分),213,215,184612,184398
1495,2,理工类(全国性加分),212,249,184861,184613
1496,2,理工类(全国性加分),211,214,185075,184862
1497,2,理工类(全国性加分),210,238,185313,185076
1498,2,理工类(全国性加分),209,195,185508,185314
1499,2,理工类(全国性加分),208,214,185722,185509
1500,2,理工类(全国性加分),207,193,185915,185723
1501,2,理工类(全国性加分),206,202,186117,185916
1502,2,理工类(全国性加分),205,193,186310,186118
1503,2,理工类(全国性加分),204,160,186470,186311
1504,2,理工类(全国性加分),203,207,186677,186471
1505,2,理工类(全国性加分),202,180,186857,186678
1506,2,理工类(全国性加分),201,197,187054,186858
1507,2,理工类(全国性加分),200,178,187232,187055
1508,2,理工类(全国性加分),199,179,187411,187233
1509,2,理工类(全国性加分),198,217,187628,187412
1510,2,理工类(全国性加分),197,153,187781,187629
1511,2,理工类(全国性加分),196,165,187946,187782
1512,2,理工类(全国性加分),195,185,188131,187947
1513,2,理工类(全国性加分),194,172,188303,188132
1514,2,理工类(全国性加分),193,178,188481,188304
1515,2,理工类(全国性加分),192,187,188668,188482
1516,2,理工类(全国性加分),191,154,188822,188669
1517,2,理工类(全国性加分),190,160,188982,188823
1518,2,理工类(全国性加分),189,158,189140,188983
1519,2,理工类(全国性加分),188,160,189300,189141
1520,2,理工类(全国性加分),187,178,189478,189301
1521,2,理工类(全国性加分),186,154,189632,189479
1522,2,理工类(全国性加分),185,148,189780,189633
1523,2,理工类(全国性加分),184,143,189923,189781
1524,2,理工类(全国性加分),183,148,190071,189924
1525,2,理工类(全国性加分),182,120,190191,190072
1526,2,理工类(全国性加分),181,128,190319,190192
1527,2,理工类(全国性加分),180,135,190454,190320
1528,3,文史类(全国性加分),662,1,11,11
1529,3,文史类(全国性加分),660,1,12,12
1530,3,文史类(全国性加分),659,1,13,13
1531,3,文史类(全国性加分),658,2,15,14
1532,3,文史类(全国性加分),657,4,19,16
1533,3,文史类(全国性加分),656,2,21,20
1534,3,文史类(全国性加分),654,2,23,22
1535,3,文史类(全国性加分),651,4,27,24
1536,3,文史类(全国性加分),650,4,31,28
1537,3,文史类(全国性加分),649,7,38,32
1538,3,文史类(全国性加分),648,4,42,39
1539,3,文史类(全国性加分),647,5,47,43
1540,3,文史类(全国性加分),646,1,48,48
1541,3,文史类(全国性加分),645,3,51,49
1542,3,文史类(全国性加分),644,1,52,52
1543,3,文史类(全国性加分),643,8,60,53
1544,3,文史类(全国性加分),642,3,63,61
1545,3,文史类(全国性加分),641,5,68,64
1546,3,文史类(全国性加分),640,4,72,69
1547,3,文史类(全国性加分),639,5,77,73
1548,3,文史类(全国性加分),638,4,81,78
1549,3,文史类(全国性加分),637,8,89,82
1550,3,文史类(全国性加分),636,12,101,90
1551,3,文史类(全国性加分),635,5,106,102
1552,3,文史类(全国性加分),634,6,112,107
1553,3,文史类(全国性加分),633,4,116,113
1554,3,文史类(全国性加分),632,5,121,117
1555,3,文史类(全国性加分),631,4,125,122
1556,3,文史类(全国性加分),630,7,132,126
1557,3,文史类(全国性加分),629,10,142,133
1558,3,文史类(全国性加分),628,23,165,143
1559,3,文史类(全国性加分),627,14,179,166
1560,3,文史类(全国性加分),626,8,187,180
1561,3,文史类(全国性加分),625,9,196,188
1562,3,文史类(全国性加分),624,15,211,197
1563,3,文史类(全国性加分),623,13,224,212
1564,3,文史类(全国性加分),622,11,235,225
1565,3,文史类(全国性加分),621,18,253,236
1566,3,文史类(全国性加分),620,16,269,254
1567,3,文史类(全国性加分),619,21,290,270
1568,3,文史类(全国性加分),618,20,310,291
1569,3,文史类(全国性加分),617,19,329,311
1570,3,文史类(全国性加分),616,18,347,330
1571,3,文史类(全国性加分),615,27,374,348
1572,3,文史类(全国性加分),614,24,398,375
1573,3,文史类(全国性加分),613,18,416,399
1574,3,文史类(全国性加分),612,22,438,417
1575,3,文史类(全国性加分),611,14,452,439
1576,3,文史类(全国性加分),610,24,476,453
1577,3,文史类(全国性加分),609,28,504,477
1578,3,文史类(全国性加分),608,32,536,505
1579,3,文史类(全国性加分),607,33,569,537
1580,3,文史类(全国性加分),606,26,595,570
1581,3,文史类(全国性加分),605,28,623,596
1582,3,文史类(全国性加分),604,22,645,624
1583,3,文史类(全国性加分),603,27,672,646
1584,3,文史类(全国性加分),602,36,708,673
1585,3,文史类(全国性加分),601,24,732,709
1586,3,文史类(全国性加分),600,36,768,733
1587,3,文史类(全国性加分),599,40,808,769
1588,3,文史类(全国性加分),598,34,842,809
1589,3,文史类(全国性加分),597,40,882,843
1590,3,文史类(全国性加分),596,44,926,883
1591,3,文史类(全国性加分),595,40,966,927
1592,3,文史类(全国性加分),594,40,1006,967
1593,3,文史类(全国性加分),593,39,1045,1007
1594,3,文史类(全国性加分),592,48,1093,1046
1595,3,文史类(全国性加分),591,48,1141,1094
1596,3,文史类(全国性加分),590,47,1188,1142
1597,3,文史类(全国性加分),589,52,1240,1189
1598,3,文史类(全国性加分),588,50,1290,1241
1599,3,文史类(全国性加分),587,55,1345,1291
1600,3,文史类(全国性加分),586,56,1401,1346
1601,3,文史类(全国性加分),585,41,1442,1402
1602,3,文史类(全国性加分),584,42,1484,1443
1603,3,文史类(全国性加分),583,54,1538,1485
1604,3,文史类(全国性加分),582,65,1603,1539
1605,3,文史类(全国性加分),581,56,1659,1604
1606,3,文史类(全国性加分),580,70,1729,1660
1607,3,文史类(全国性加分),579,51,1780,1730
1608,3,文史类(全国性加分),578,69,1849,1781
1609,3,文史类(全国性加分),577,62,1911,1850
1610,3,文史类(全国性加分),576,77,1988,1912
1611,3,文史类(全国性加分),575,80,2068,1989
1612,3,文史类(全国性加分),574,81,2149,2069
1613,3,文史类(全国性加分),573,77,2226,2150
1614,3,文史类(全国性加分),572,73,2299,2227
1615,3,文史类(全国性加分),571,82,2381,2300
1616,3,文史类(全国性加分),570,71,2452,2382
1617,3,文史类(全国性加分),569,78,2530,2453
1618,3,文史类(全国性加分),568,70,2600,2531
1619,3,文史类(全国性加分),567,96,2696,2601
1620,3,文史类(全国性加分),566,72,2768,2697
1621,3,文史类(全国性加分),565,75,2843,2769
1622,3,文史类(全国性加分),564,87,2930,2844
1623,3,文史类(全国性加分),563,87,3017,2931
1624,3,文史类(全国性加分),562,93,3110,3018
1625,3,文史类(全国性加分),561,91,3201,3111
1626,3,文史类(全国性加分),560,107,3308,3202
1627,3,文史类(全国性加分),559,118,3426,3309
1628,3,文史类(全国性加分),558,112,3538,3427
1629,3,文史类(全国性加分),557,112,3650,3539
1630,3,文史类(全国性加分),556,107,3757,3651
1631,3,文史类(全国性加分),555,106,3863,3758
1632,3,文史类(全国性加分),554,119,3982,3864
1633,3,文史类(全国性加分),553,139,4121,3983
1634,3,文史类(全国性加分),552,118,4239,4122
1635,3,文史类(全国性加分),551,121,4360,4240
1636,3,文史类(全国性加分),550,105,4465,4361
1637,3,文史类(全国性加分),549,125,4590,4466
1638,3,文史类(全国性加分),548,126,4716,4591
1639,3,文史类(全国性加分),547,126,4842,4717
1640,3,文史类(全国性加分),546,144,4986,4843
1641,3,文史类(全国性加分),545,144,5130,4987
1642,3,文史类(全国性加分),544,149,5279,5131
1643,3,文史类(全国性加分),543,160,5439,5280
1644,3,文史类(全国性加分),542,134,5573,5440
1645,3,文史类(全国性加分),541,137,5710,5574
1646,3,文史类(全国性加分),540,145,5855,5711
1647,3,文史类(全国性加分),539,166,6021,5856
1648,3,文史类(全国性加分),538,158,6179,6022
1649,3,文史类(全国性加分),537,174,6353,6180
1650,3,文史类(全国性加分),536,144,6497,6354
1651,3,文史类(全国性加分),535,173,6670,6498
1652,3,文史类(全国性加分),534,163,6833,6671
1653,3,文史类(全国性加分),533,147,6980,6834
1654,3,文史类(全国性加分),532,167,7147,6981
1655,3,文史类(全国性加分),531,158,7305,7148
1656,3,文史类(全国性加分),530,184,7489,7306
1657,3,文史类(全国性加分),529,188,7677,7490
1658,3,文史类(全国性加分),528,146,7823,7678
1659,3,文史类(全国性加分),527,159,7982,7824
1660,3,文史类(全国性加分),526,179,8161,7983
1661,3,文史类(全国性加分),525,169,8330,8162
1662,3,文史类(全国性加分),524,170,8500,8331
1663,3,文史类(全国性加分),523,174,8674,8501
1664,3,文史类(全国性加分),522,166,8840,8675
1665,3,文史类(全国性加分),521,160,9000,8841
1666,3,文史类(全国性加分),520,196,9196,9001
1667,3,文史类(全国性加分),519,189,9385,9197
1668,3,文史类(全国性加分),518,202,9587,9386
1669,3,文史类(全国性加分),517,194,9781,9588
1670,3,文史类(全国性加分),516,179,9960,9782
1671,3,文史类(全国性加分),515,212,10172,9961
1672,3,文史类(全国性加分),514,216,10388,10173
1673,3,文史类(全国性加分),513,178,10566,10389
1674,3,文史类(全国性加分),512,194,10760,10567
1675,3,文史类(全国性加分),511,203,10963,10761
1676,3,文史类(全国性加分),510,203,11166,10964
1677,3,文史类(全国性加分),509,213,11379,11167
1678,3,文史类(全国性加分),508,196,11575,11380
1679,3,文史类(全国性加分),507,229,11804,11576
1680,3,文史类(全国性加分),506,244,12048,11805
1681,3,文史类(全国性加分),505,227,12275,12049
1682,3,文史类(全国性加分),504,205,12480,12276
1683,3,文史类(全国性加分),503,216,12696,12481
1684,3,文史类(全国性加分),502,237,12933,12697
1685,3,文史类(全国性加分),501,228,13161,12934
1686,3,文史类(全国性加分),500,232,13393,13162
1687,3,文史类(全国性加分),499,234,13627,13394
1688,3,文史类(全国性加分),498,214,13841,13628
1689,3,文史类(全国性加分),497,216,14057,13842
1690,3,文史类(全国性加分),496,238,14295,14058
1691,3,文史类(全国性加分),495,255,14550,14296
1692,3,文史类(全国性加分),494,248,14798,14551
1693,3,文史类(全国性加分),493,236,15034,14799
1694,3,文史类(全国性加分),492,247,15281,15035
1695,3,文史类(全国性加分),491,232,15513,15282
1696,3,文史类(全国性加分),490,234,15747,15514
1697,3,文史类(全国性加分),489,270,16017,15748
1698,3,文史类(全国性加分),488,253,16270,16018
1699,3,文史类(全国性加分),487,215,16485,16271
1700,3,文史类(全国性加分),486,256,16741,16486
1701,3,文史类(全国性加分),485,252,16993,16742
1702,3,文史类(全国性加分),484,245,17238,16994
1703,3,文史类(全国性加分),483,268,17506,17239
1704,3,文史类(全国性加分),482,281,17787,17507
1705,3,文史类(全国性加分),481,279,18066,17788
1706,3,文史类(全国性加分),480,279,18345,18067
1707,3,文史类(全国性加分),479,268,18613,18346
1708,3,文史类(全国性加分),478,284,18897,18614
1709,3,文史类(全国性加分),477,289,19186,18898
1710,3,文史类(全国性加分),476,237,19423,19187
1711,3,文史类(全国性加分),475,318,19741,19424
1712,3,文史类(全国性加分),474,285,20026,19742
1713,3,文史类(全国性加分),473,294,20320,20027
1714,3,文史类(全国性加分),472,312,20632,20321
1715,3,文史类(全国性加分),471,318,20950,20633
1716,3,文史类(全国性加分),470,307,21257,20951
1717,3,文史类(全国性加分),469,279,21536,21258
1718,3,文史类(全国性加分),468,288,21824,21537
1719,3,文史类(全国性加分),467,287,22111,21825
1720,3,文史类(全国性加分),466,301,22412,22112
1721,3,文史类(全国性加分),465,285,22697,22413
1722,3,文史类(全国性加分),464,296,22993,22698
1723,3,文史类(全国性加分),463,291,23284,22994
1724,3,文史类(全国性加分),462,331,23615,23285
1725,3,文史类(全国性加分),461,322,23937,23616
1726,3,文史类(全国性加分),460,316,24253,23938
1727,3,文史类(全国性加分),459,297,24550,24254
1728,3,文史类(全国性加分),458,314,24864,24551
1729,3,文史类(全国性加分),457,349,25213,24865
1730,3,文史类(全国性加分),456,349,25562,25214
1731,3,文史类(全国性加分),455,343,25905,25563
1732,3,文史类(全国性加分),454,319,26224,25906
1733,3,文史类(全国性加分),453,344,26568,26225
1734,3,文史类(全国性加分),452,309,26877,26569
1735,3,文史类(全国性加分),451,303,27180,26878
1736,3,文史类(全国性加分),450,330,27510,27181
1737,3,文史类(全国性加分),449,324,27834,27511
1738,3,文史类(全国性加分),448,306,28140,27835
1739,3,文史类(全国性加分),447,354,28494,28141
1740,3,文史类(全国性加分),446,326,28820,28495
1741,3,文史类(全国性加分),445,368,29188,28821
1742,3,文史类(全国性加分),444,345,29533,29189
1743,3,文史类(全国性加分),443,356,29889,29534
1744,3,文史类(全国性加分),442,322,30211,29890
1745,3,文史类(全国性加分),441,321,30532,30212
1746,3,文史类(全国性加分),440,368,30900,30533
1747,3,文史类(全国性加分),439,330,31230,30901
1748,3,文史类(全国性加分),438,363,31593,31231
1749,3,文史类(全国性加分),437,351,31944,31594
1750,3,文史类(全国性加分),436,354,32298,31945
1751,3,文史类(全国性加分),435,365,32663,32299
1752,3,文史类(全国性加分),434,316,32979,32664
1753,3,文史类(全国性加分),433,381,33360,32980
1754,3,文史类(全国性加分),432,397,33757,33361
1755,3,文史类(全国性加分),431,378,34135,33758
1756,3,文史类(全国性加分),430,371,34506,34136
1757,3,文史类(全国性加分),429,337,34843,34507
1758,3,文史类(全国性加分),428,353,35196,34844
1759,3,文史类(全国性加分),427,394,35590,35197
1760,3,文史类(全国性加分),426,332,35922,35591
1761,3,文史类(全国性加分),425,404,36326,35923
1762,3,文史类(全国性加分),424,405,36731,36327
1763,3,文史类(全国性加分),423,424,37155,36732
1764,3,文史类(全国性加分),422,380,37535,37156
1765,3,文史类(全国性加分),421,396,37931,37536
1766,3,文史类(全国性加分),420,413,38344,37932
1767,3,文史类(全国性加分),419,384,38728,38345
1768,3,文史类(全国性加分),418,398,39126,38729
1769,3,文史类(全国性加分),417,382,39508,39127
1770,3,文史类(全国性加分),416,414,39922,39509
1771,3,文史类(全国性加分),415,403,40325,39923
1772,3,文史类(全国性加分),414,411,40736,40326
1773,3,文史类(全国性加分),413,392,41128,40737
1774,3,文史类(全国性加分),412,395,41523,41129
1775,3,文史类(全国性加分),411,430,41953,41524
1776,3,文史类(全国性加分),410,424,42377,41954
1777,3,文史类(全国性加分),409,422,42799,42378
1778,3,文史类(全国性加分),408,390,43189,42800
1779,3,文史类(全国性加分),407,483,43672,43190
1780,3,文史类(全国性加分),406,411,44083,43673
1781,3,文史类(全国性加分),405,409,44492,44084
1782,3,文史类(全国性加分),404,407,44899,44493
1783,3,文史类(全国性加分),403,415,45314,44900
1784,3,文史类(全国性加分),402,438,45752,45315
1785,3,文史类(全国性加分),401,434,46186,45753
1786,3,文史类(全国性加分),400,406,46592,46187
1787,3,文史类(全国性加分),399,438,47030,46593
1788,3,文史类(全国性加分),398,426,47456,47031
1789,3,文史类(全国性加分),397,419,47875,47457
1790,3,文史类(全国性加分),396,463,48338,47876
1791,3,文史类(全国性加分),395,435,48773,48339
1792,3,文史类(全国性加分),394,419,49192,48774
1793,3,文史类(全国性加分),393,432,49624,49193
1794,3,文史类(全国性加分),392,395,50019,49625
1795,3,文史类(全国性加分),391,408,50427,50020
1796,3,文史类(全国性加分),390,458,50885,50428
1797,3,文史类(全国性加分),389,386,51271,50886
1798,3,文史类(全国性加分),388,454,51725,51272
1799,3,文史类(全国性加分),387,442,52167,51726
1800,3,文史类(全国性加分),386,437,52604,52168
1801,3,文史类(全国性加分),385,449,53053,52605
1802,3,文史类(全国性加分),384,452,53505,53054
1803,3,文史类(全国性加分),383,438,53943,53506
1804,3,文史类(全国性加分),382,443,54386,53944
1805,3,文史类(全国性加分),381,481,54867,54387
1806,3,文史类(全国性加分),380,493,55360,54868
1807,3,文史类(全国性加分),379,435,55795,55361
1808,3,文史类(全国性加分),378,448,56243,55796
1809,3,文史类(全国性加分),377,441,56684,56244
1810,3,文史类(全国性加分),376,456,57140,56685
1811,3,文史类(全国性加分),375,453,57593,57141
1812,3,文史类(全国性加分),374,467,58060,57594
1813,3,文史类(全国性加分),373,434,58494,58061
1814,3,文史类(全国性加分),372,450,58944,58495
1815,3,文史类(全国性加分),371,472,59416,58945
1816,3,文史类(全国性加分),370,440,59856,59417
1817,3,文史类(全国性加分),369,464,60320,59857
1818,3,文史类(全国性加分),368,444,60764,60321
1819,3,文史类(全国性加分),367,462,61226,60765
1820,3,文史类(全国性加分),366,421,61647,61227
1821,3,文史类(全国性加分),365,477,62124,61648
1822,3,文史类(全国性加分),364,492,62616,62125
1823,3,文史类(全国性加分),363,488,63104,62617
1824,3,文史类(全国性加分),362,449,63553,63105
1825,3,文史类(全国性加分),361,468,64021,63554
1826,3,文史类(全国性加分),360,453,64474,64022
1827,3,文史类(全国性加分),359,436,64910,64475
1828,3,文史类(全国性加分),358,475,65385,64911
1829,3,文史类(全国性加分),357,467,65852,65386
1830,3,文史类(全国性加分),356,435,66287,65853
1831,3,文史类(全国性加分),355,426,66713,66288
1832,3,文史类(全国性加分),354,486,67199,66714
1833,3,文史类(全国性加分),353,451,67650,67200
1834,3,文史类(全国性加分),352,454,68104,67651
1835,3,文史类(全国性加分),351,490,68594,68105
1836,3,文史类(全国性加分),350,436,69030,68595
1837,3,文史类(全国性加分),349,450,69480,69031
1838,3,文史类(全国性加分),348,430,69910,69481
1839,3,文史类(全国性加分),347,452,70362,69911
1840,3,文史类(全国性加分),346,457,70819,70363
1841,3,文史类(全国性加分),345,467,71286,70820
1842,3,文史类(全国性加分),344,471,71757,71287
1843,3,文史类(全国性加分),343,444,72201,71758
1844,3,文史类(全国性加分),342,469,72670,72202
1845,3,文史类(全国性加分),341,466,73136,72671
1846,3,文史类(全国性加分),340,431,73567,73137
1847,3,文史类(全国性加分),339,476,74043,73568
1848,3,文史类(全国性加分),338,476,74519,74044
1849,3,文史类(全国性加分),337,458,74977,74520
1850,3,文史类(全国性加分),336,415,75392,74978
1851,3,文史类(全国性加分),335,467,75859,75393
1852,3,文史类(全国性加分),334,429,76288,75860
1853,3,文史类(全国性加分),333,491,76779,76289
1854,3,文史类(全国性加分),332,467,77246,76780
1855,3,文史类(全国性加分),331,477,77723,77247
1856,3,文史类(全国性加分),330,480,78203,77724
1857,3,文史类(全国性加分),329,476,78679,78204
1858,3,文史类(全国性加分),328,472,79151,78680
1859,3,文史类(全国性加分),327,452,79603,79152
1860,3,文史类(全国性加分),326,445,80048,79604
1861,3,文史类(全国性加分),325,442,80490,80049
1862,3,文史类(全国性加分),324,453,80943,80491
1863,3,文史类(全国性加分),323,468,81411,80944
1864,3,文史类(全国性加分),322,412,81823,81412
1865,3,文史类(全国性加分),321,466,82289,81824
1866,3,文史类(全国性加分),320,434,82723,82290
1867,3,文史类(全国性加分),319,477,83200,82724
1868,3,文史类(全国性加分),318,446,83646,83201
1869,3,文史类(全国性加分),317,431,84077,83647
1870,3,文史类(全国性加分),316,431,84508,84078
1871,3,文史类(全国性加分),315,461,84969,84509
1872,3,文史类(全国性加分),314,379,85348,84970
1873,3,文史类(全国性加分),313,476,85824,85349
1874,3,文史类(全国性加分),312,463,86287,85825
1875,3,文史类(全国性加分),311,418,86705,86288
1876,3,文史类(全国性加分),310,437,87142,86706
1877,3,文史类(全国性加分),309,425,87567,87143
1878,3,文史类(全国性加分),308,465,88032,87568
1879,3,文史类(全国性加分),307,386,88418,88033
1880,3,文史类(全国性加分),306,455,88873,88419
1881,3,文史类(全国性加分),305,437,89310,88874
1882,3,文史类(全国性加分),304,436,89746,89311
1883,3,文史类(全国性加分),303,384,90130,89747
1884,3,文史类(全国性加分),302,412,90542,90131
1885,3,文史类(全国性加分),301,418,90960,90543
1886,3,文史类(全国性加分),300,411,91371,90961
1887,3,文史类(全国性加分),299,400,91771,91372
1888,3,文史类(全国性加分),298,399,92170,91772
1889,3,文史类(全国性加分),297,394,92564,92171
1890,3,文史类(全国性加分),296,422,92986,92565
1891,3,文史类(全国性加分),295,366,93352,92987
1892,3,文史类(全国性加分),294,380,93732,93353
1893,3,文史类(全国性加分),293,419,94151,93733
1894,3,文史类(全国性加分),292,402,94553,94152
1895,3,文史类(全国性加分),291,346,94899,94554
1896,3,文史类(全国性加分),290,369,95268,94900
1897,3,文史类(全国性加分),289,389,95657,95269
1898,3,文史类(全国性加分),288,375,96032,95658
1899,3,文史类(全国性加分),287,353,96385,96033
1900,3,文史类(全国性加分),286,366,96751,96386
1901,3,文史类(全国性加分),285,384,97135,96752
1902,3,文史类(全国性加分),284,366,97501,97136
1903,3,文史类(全国性加分),283,373,97874,97502
1904,3,文史类(全国性加分),282,350,98224,97875
1905,3,文史类(全国性加分),281,364,98588,98225
1906,3,文史类(全国性加分),280,335,98923,98589
1907,3,文史类(全国性加分),279,361,99284,98924
1908,3,文史类(全国性加分),278,336,99620,99285
1909,3,文史类(全国性加分),277,328,99948,99621
1910,3,文史类(全国性加分),276,344,100292,99949
1911,3,文史类(全国性加分),275,342,100634,100293
1912,3,文史类(全国性加分),274,336,100970,100635
1913,3,文史类(全国性加分),273,358,101328,100971
1914,3,文史类(全国性加分),272,304,101632,101329
1915,3,文史类(全国性加分),271,358,101990,101633
1916,3,文史类(全国性加分),270,330,102320,101991
1917,3,文史类(全国性加分),269,291,102611,102321
1918,3,文史类(全国性加分),268,336,102947,102612
1919,3,文史类(全国性加分),267,306,103253,102948
1920,3,文史类(全国性加分),266,291,103544,103254
1921,3,文史类(全国性加分),265,292,103836,103545
1922,3,文史类(全国性加分),264,321,104157,103837
1923,3,文史类(全国性加分),263,316,104473,104158
1924,3,文史类(全国性加分),262,306,104779,104474
1925,3,文史类(全国性加分),261,306,105085,104780
1926,3,文史类(全国性加分),260,282,105367,105086
1927,3,文史类(全国性加分),259,284,105651,105368
1928,3,文史类(全国性加分),258,243,105894,105652
1929,3,文史类(全国性加分),257,265,106159,105895
1930,3,文史类(全国性加分),256,256,106415,106160
1931,3,文史类(全国性加分),255,258,106673,106416
1932,3,文史类(全国性加分),254,289,106962,106674
1933,3,文史类(全国性加分),253,285,107247,106963
1934,3,文史类(全国性加分),252,243,107490,107248
1935,3,文史类(全国性加分),251,245,107735,107491
1936,3,文史类(全国性加分),250,251,107986,107736
1937,3,文史类(全国性加分),249,236,108222,107987
1938,3,文史类(全国性加分),248,244,108466,108223
1939,3,文史类(全国性加分),247,246,108712,108467
1940,3,文史类(全国性加分),246,219,108931,108713
1941,3,文史类(全国性加分),245,262,109193,108932
1942,3,文史类(全国性加分),244,227,109420,109194
1943,3,文史类(全国性加分),243,206,109626,109421
1944,3,文史类(全国性加分),242,181,109807,109627
1945,3,文史类(全国性加分),241,226,110033,109808
1946,3,文史类(全国性加分),240,207,110240,110034
1947,3,文史类(全国性加分),239,198,110438,110241
1948,3,文史类(全国性加分),238,196,110634,110439
1949,3,文史类(全国性加分),237,179,110813,110635
1950,3,文史类(全国性加分),236,196,111009,110814
1951,3,文史类(全国性加分),235,226,111235,111010
1952,3,文史类(全国性加分),234,198,111433,111236
1953,3,文史类(全国性加分),233,189,111622,111434
1954,3,文史类(全国性加分),232,164,111786,111623
1955,3,文史类(全国性加分),231,168,111954,111787
1956,3,文史类(全国性加分),230,161,112115,111955
1957,3,文史类(全国性加分),229,148,112263,112116
1958,3,文史类(全国性加分),228,174,112437,112264
1959,3,文史类(全国性加分),227,152,112589,112438
1960,3,文史类(全国性加分),226,165,112754,112590
1961,3,文史类(全国性加分),225,157,112911,112755
1962,3,文史类(全国性加分),224,139,113050,112912
1963,3,文史类(全国性加分),223,140,113190,113051
1964,3,文史类(全国性加分),222,145,113335,113191
1965,3,文史类(全国性加分),221,155,113490,113336
1966,3,文史类(全国性加分),220,151,113641,113491
1967,3,文史类(全国性加分),219,130,113771,113642
1968,3,文史类(全国性加分),218,135,113906,113772
1969,3,文史类(全国性加分),217,150,114056,113907
1970,3,文史类(全国性加分),216,120,114176,114057
1971,3,文史类(全国性加分),215,122,114298,114177
1972,3,文史类(全国性加分),214,124,114422,114299
1973,3,文史类(全国性加分),213,112,114534,114423
1974,3,文史类(全国性加分),212,110,114644,114535
1975,3,文史类(全国性加分),211,127,114771,114645
1976,3,文史类(全国性加分),210,109,114880,114772
1977,3,文史类(全国性加分),209,114,114994,114881
1978,3,文史类(全国性加分),208,103,115097,114995
1979,3,文史类(全国性加分),207,103,115200,115098
1980,3,文史类(全国性加分),206,87,115287,115201
1981,3,文史类(全国性加分),205,99,115386,115288
1982,3,文史类(全国性加分),204,91,115477,115387
1983,3,文史类(全国性加分),203,87,115564,115478
1984,3,文史类(全国性加分),202,95,115659,115565
1985,3,文史类(全国性加分),201,87,115746,115660
1986,3,文史类(全国性加分),200,93,115839,115747
1987,3,文史类(全国性加分),199,81,115920,115840
1988,3,文史类(全国性加分),198,84,116004,115921
1989,3,文史类(全国性加分),197,67,116071,116005
1990,3,文史类(全国性加分),196,70,116141,116072
1991,3,文史类(全国性加分),195,82,116223,116142
1992,3,文史类(全国性加分),194,77,116300,116224
1993,3,文史类(全国性加分),193,67,116367,116301
1994,3,文史类(全国性加分),192,69,116436,116368
1995,3,文史类(全国性加分),191,62,116498,116437
1996,3,文史类(全国性加分),190,61,116559,116499
1997,3,文史类(全国性加分),189,57,116616,116560
1998,3,文史类(全国性加分),188,62,116678,116617
1999,3,文史类(全国性加分),187,70,116748,116679
2000,3,文史类(全国性加分),186,48,116796,116749
2001,3,文史类(全国性加分),185,61,116857,116797
2002,3,文史类(全国性加分),184,61,116918,116858
2003,3,文史类(全国性加分),183,58,116976,116919
2004,3,文史类(全国性加分),182,58,117034,116977
2005,3,文史类(全国性加分),181,44,117078,117035
2006,3,文史类(全国性加分),180,39,117117,117079
